calls_answered,calls_total,calls_missed,date,calls_answered_ratio,calls_answered_ratio_calc,region,region_id
4134,5057,923,2019-11-30,81.75 %,0.8174807198,sörmland,4
6574,8093,1519,2019-12-31,81.23 %,0.8123069319,sörmland,4
8873,12878,4005,2020-01-31,68.90 %,0.6890045038,sörmland,4
8797,13173,4376,2020-02-29,66.78 %,0.6678053594,sörmland,4
10979,22308,11329,2020-03-31,49.22 %,0.4921552806,sörmland,4
11435,16815,5380,2020-04-30,68.00 %,0.6800475766,sörmland,4
10986,13900,2914,2020-05-31,79.04 %,0.7903597122,sörmland,4
9160,15174,6014,2020-06-30,60.37 %,0.6036641624,sörmland,4
8918,13358,4440,2020-07-31,66.76 %,0.6676149124,sörmland,4
9413,13160,3747,2020-08-31,71.53 %,0.7152735562,sörmland,4
9100,13992,4892,2020-09-30,65.04 %,0.6503716409,sörmland,4
9903,14818,4915,2020-10-31,66.83 %,0.6683088136,sörmland,4
10859,18147,7288,2020-11-30,59.84 %,0.5983909186,sörmland,4
10138,15587,5449,2020-12-31,65.04 %,0.6504138064,sörmland,4
9913,14556,4643,2021-01-31,68.10 %,0.6810250069,sörmland,4
8796,12797,4001,2021-02-28,68.73 %,0.6873485973,sörmland,4
10952,18017,7065,2021-03-31,60.79 %,0.6078703447,sörmland,4
10080,18642,8562,2021-04-30,54.07 %,0.5407145156,sörmland,4
10057,16886,6829,2021-05-31,59.56 %,0.5955821391,sörmland,4
8657,15715,7058,2021-06-30,55.09 %,0.5508749602,sörmland,4
7770,15799,8029,2021-07-31,49.18 %,0.4918032787,sörmland,4
8283,14276,5993,2021-08-31,58.02 %,0.5802045391,sörmland,4
8709,13190,4481,2021-09-30,66.03 %,0.660272934,sörmland,4
9076,14485,5409,2021-10-31,62.66 %,0.6265792199,sörmland,4
8684,12859,4175,2021-11-30,67.53 %,0.6753246753,sörmland,4
9795,14572,4777,2021-12-31,67.22 %,0.6721795224,sörmland,4
56364,81185,24821,2017-01-31,69.43 %,0.6942661822,västragötland,14
52650,77212,24562,2017-02-28,68.19 %,0.6818888256,västragötland,14
57365,81784,24419,2017-03-31,70.14 %,0.7014208158,västragötland,14
51387,76108,24721,2017-04-30,67.52 %,0.675185263,västragötland,14
52242,82681,30439,2017-05-31,63.19 %,0.6318501228,västragötland,14
50268,75230,24962,2017-06-30,66.82 %,0.6681908813,västragötland,14
44300,71921,27621,2017-07-31,61.60 %,0.6159536158,västragötland,14
48230,66918,18688,2017-08-31,72.07 %,0.7207328372,västragötland,14
48599,67990,19391,2017-09-30,71.48 %,0.7147962936,västragötland,14
49134,72351,23217,2017-10-31,67.91 %,0.6791060248,västragötland,14
48488,68442,19954,2017-11-30,70.85 %,0.7084538734,västragötland,14
50126,76352,26226,2017-12-31,65.65 %,0.6565119447,västragötland,14
52829,84101,31272,2018-01-31,62.82 %,0.6281613774,västragötland,14
44201,78327,34126,2018-02-28,56.43 %,0.5643137105,västragötland,14
49399,86931,37532,2018-03-31,56.83 %,0.5682552829,västragötland,14
47019,74361,27342,2018-04-30,63.23 %,0.6323072578,västragötland,14
47459,75206,27747,2018-05-31,63.11 %,0.6310533734,västragötland,14
44778,71480,26702,2018-06-30,62.64 %,0.6264409625,västragötland,14
41500,69721,28221,2018-07-31,59.52 %,0.5952295578,västragötland,14
43657,65606,21949,2018-08-31,66.54 %,0.6654421852,västragötland,14
44995,65175,20180,2018-09-30,69.04 %,0.6903720752,västragötland,14
48056,68170,20114,2018-10-31,70.49 %,0.7049435235,västragötland,14
46677,63728,17051,2018-11-30,73.24 %,0.7324409992,västragötland,14
47903,61561,13658,2018-12-31,77.81 %,0.7781387567,västragötland,14
53157,66844,13687,2019-01-31,79.52 %,0.7952396625,västragötland,14
47715,60652,12937,2019-02-28,78.67 %,0.7867011805,västragötland,14
50635,63339,12704,2019-03-31,79.94 %,0.7994284722,västragötland,14
49143,62550,13407,2019-04-30,78.57 %,0.7856594724,västragötland,14
49859,62108,12249,2019-05-31,80.28 %,0.8027790301,västragötland,14
46597,59769,13172,2019-06-30,77.96 %,0.7796181967,västragötland,14
43883,56996,13113,2019-07-31,76.99 %,0.7699312232,västragötland,14
46425,57940,11515,2019-08-31,80.13 %,0.8012599241,västragötland,14
48350,59092,10742,2019-09-30,81.82 %,0.8182156637,västragötland,14
50612,61127,10515,2019-10-31,82.80 %,0.8279810886,västragötland,14
49513,61855,12342,2019-11-30,80.05 %,0.8004688384,västragötland,14
50519,64528,14009,2019-12-31,78.29 %,0.7829004463,västragötland,14
52812,66400,13588,2020-01-31,79.54 %,0.7953614458,västragötland,14
48715,65330,16615,2020-02-29,74.57 %,0.7456757998,västragötland,14
60354,105913,45559,2020-03-31,56.98 %,0.5698450615,västragötland,14
58257,79750,21493,2020-04-30,73.05 %,0.7304952978,västragötland,14
55297,73785,18488,2020-05-31,74.94 %,0.7494341668,västragötland,14
48173,73984,25811,2020-06-30,65.11 %,0.6511272708,västragötland,14
41798,61158,19360,2020-07-31,68.34 %,0.6834428856,västragötland,14
44916,66989,22073,2020-08-31,67.05 %,0.6704981415,västragötland,14
44313,63373,19060,2020-09-30,69.92 %,0.6992410017,västragötland,14
47114,65757,18643,2020-10-31,71.65 %,0.7164864577,västragötland,14
48167,77156,28989,2020-11-30,62.43 %,0.6242806781,västragötland,14
50365,77720,27355,2020-12-31,64.80 %,0.6480313948,västragötland,14
49705,70438,20733,2021-01-31,70.57 %,0.7056560379,västragötland,14
43453,61954,18501,2021-02-28,70.14 %,0.7013752139,västragötland,14
48796,77717,28921,2021-03-31,62.79 %,0.6278677767,västragötland,14
45588,78202,32614,2021-04-30,58.30 %,0.5829518427,västragötland,14
44479,72743,28264,2021-05-31,61.15 %,0.6114540231,västragötland,14
39972,68068,28096,2021-06-30,58.72 %,0.5872362931,västragötland,14
37248,68174,30926,2021-07-31,54.64 %,0.54636665,västragötland,14
39379,63623,24244,2021-08-31,61.89 %,0.6189428351,västragötland,14
41242,63120,21878,2021-09-30,65.34 %,0.6533903676,västragötland,14
40017,69145,29128,2021-10-31,57.87 %,0.5787403283,västragötland,14
39008,55440,16432,2021-11-30,70.36 %,0.7036075036,västragötland,14
41264,59456,18192,2021-12-31,69.40 %,0.6940258342,västragötland,14
11727,14205,2478,2017-01-31,82.56 %,0.8255543823,västernorrland,22
10558,13491,2933,2017-02-28,78.26 %,0.7825958046,västernorrland,22
10749,13118,2369,2017-03-31,81.94 %,0.8194084464,västernorrland,22
10577,12523,1946,2017-04-30,84.46 %,0.8446059251,västernorrland,22
10904,13481,2577,2017-05-31,80.88 %,0.808842074,västernorrland,22
10098,12487,2389,2017-06-30,80.87 %,0.8086810283,västernorrland,22
10391,13109,2718,2017-07-31,79.27 %,0.7926615302,västernorrland,22
9692,11726,2034,2017-08-31,82.65 %,0.8265393143,västernorrland,22
9903,11587,1684,2017-09-30,85.47 %,0.8546647105,västernorrland,22
10220,12324,2104,2017-10-31,82.93 %,0.829276209,västernorrland,22
10045,11917,1872,2017-11-30,84.29 %,0.8429134849,västernorrland,22
10794,12876,2082,2017-12-31,83.83 %,0.8383038211,västernorrland,22
10848,13603,2755,2018-01-31,79.75 %,0.7974711461,västernorrland,22
9619,13455,3836,2018-02-28,71.49 %,0.7149015236,västernorrland,22
10519,14199,3680,2018-03-31,74.08 %,0.7408268188,västernorrland,22
10322,13314,2992,2018-04-30,77.53 %,0.7752741475,västernorrland,22
10242,13179,2937,2018-05-31,77.71 %,0.7771454587,västernorrland,22
10176,13186,3010,2018-06-30,77.17 %,0.7717275899,västernorrland,22
10630,14578,3948,2018-07-31,72.92 %,0.7291809576,västernorrland,22
10145,13196,3051,2018-08-31,76.88 %,0.7687935738,västernorrland,22
9737,12255,2518,2018-09-30,79.45 %,0.7945328437,västernorrland,22
10535,12789,2254,2018-10-31,82.38 %,0.8237547893,västernorrland,22
10652,13278,2626,2018-11-30,80.22 %,0.8022292514,västernorrland,22
10958,13327,2369,2018-12-31,82.22 %,0.8222405643,västernorrland,22
10953,13201,2248,2019-01-31,82.97 %,0.8297098705,västernorrland,22
9809,12418,2609,2019-02-28,78.99 %,0.7899017555,västernorrland,22
10692,12986,2294,2019-03-31,82.33 %,0.8233482212,västernorrland,22
11033,13314,2281,2019-04-30,82.87 %,0.828676581,västernorrland,22
10707,12988,2281,2019-05-31,82.44 %,0.8243763474,västernorrland,22
10390,12623,2233,2019-06-30,82.31 %,0.8231006892,västernorrland,22
10499,12968,2469,2019-07-31,80.96 %,0.8096082665,västernorrland,22
10000,11647,1647,2019-08-31,85.86 %,0.8585901949,västernorrland,22
9902,11680,1778,2019-09-30,84.78 %,0.8477739726,västernorrland,22
9979,12105,2126,2019-10-31,82.44 %,0.824370095,västernorrland,22
9720,11843,2123,2019-11-30,82.07 %,0.8207379887,västernorrland,22
10740,12941,2201,2019-12-31,82.99 %,0.829920408,västernorrland,22
11064,13425,2361,2020-01-31,82.41 %,0.8241340782,västernorrland,22
10467,13335,2868,2020-02-29,78.49 %,0.7849268841,västernorrland,22
11675,16548,4873,2020-03-31,70.55 %,0.7055233261,västernorrland,22
10327,13241,2914,2020-04-30,77.99 %,0.7799259875,västernorrland,22
10375,12937,2562,2020-05-31,80.20 %,0.8019633609,västernorrland,22
9954,13673,3719,2020-06-30,72.80 %,0.7280040957,västernorrland,22
10416,14037,3621,2020-07-31,74.20 %,0.7420388972,västernorrland,22
9757,12975,3218,2020-08-31,75.20 %,0.7519845857,västernorrland,22
10399,13885,3486,2020-09-30,74.89 %,0.7489377026,västernorrland,22
10289,12940,2651,2020-10-31,79.51 %,0.7951313756,västernorrland,22
11961,16195,4234,2020-11-30,73.86 %,0.7385612843,västernorrland,22
11877,15062,3185,2020-12-31,78.85 %,0.7885406984,västernorrland,22
11187,13453,2266,2021-01-31,83.16 %,0.8315617334,västernorrland,22
9900,12244,2344,2021-02-28,80.86 %,0.8085592943,västernorrland,22
12422,16663,4241,2021-03-31,74.55 %,0.7454840065,västernorrland,22
12632,17789,5157,2021-04-30,71.01 %,0.7101017483,västernorrland,22
11303,14570,3267,2021-05-31,77.58 %,0.7757721345,västernorrland,22
9617,12081,2464,2021-06-30,79.60 %,0.7960433739,västernorrland,22
9578,12768,3190,2021-07-31,75.02 %,0.7501566416,västernorrland,22
9716,11647,1931,2021-08-31,83.42 %,0.8342062334,västernorrland,22
9392,11504,2112,2021-09-30,81.64 %,0.8164116829,västernorrland,22
9677,12148,2471,2021-10-31,79.66 %,0.7965920316,västernorrland,22
9988,13660,3672,2021-11-30,73.12 %,0.7311859444,västernorrland,22
10220,13203,2983,2021-12-31,77.41 %,0.7740665,västernorrland,22
6353,7466,1113,2017-01-31,85.09 %,0.8509241897,jämtland,23
6245,7752,1507,2017-02-28,80.56 %,0.8055985552,jämtland,23
6305,7293,988,2017-03-31,86.45 %,0.8645276292,jämtland,23
6317,7376,1059,2017-04-30,85.64 %,0.8564262473,jämtland,23
6018,7173,1155,2017-05-31,83.90 %,0.8389795065,jämtland,23
5595,6885,1290,2017-06-30,81.26 %,0.8126361656,jämtland,23
5771,7393,1622,2017-07-31,78.06 %,0.7806032734,jämtland,23
5285,6125,840,2017-08-31,86.29 %,0.8628571429,jämtland,23
5012,5783,771,2017-09-30,86.67 %,0.8666781947,jämtland,23
5207,6196,989,2017-10-31,84.04 %,0.8403808909,jämtland,23
5114,6249,1135,2017-11-30,81.84 %,0.8183709394,jämtland,23
5903,7242,1339,2017-12-31,81.51 %,0.8151063242,jämtland,23
5635,7203,1568,2018-01-31,78.23 %,0.7823129252,jämtland,23
5597,7440,1843,2018-02-28,75.23 %,0.7522849462,jämtland,23
5909,8056,2147,2018-03-31,73.35 %,0.733490566,jämtland,23
5458,7027,1569,2018-04-30,77.67 %,0.776718372,jämtland,23
5031,6168,1137,2018-05-31,81.57 %,0.8156614786,jämtland,23
5248,6482,1234,2018-06-30,80.96 %,0.8096266584,jämtland,23
5308,6994,1686,2018-07-31,75.89 %,0.7589362311,jämtland,23
5147,6103,956,2018-08-31,84.34 %,0.8433557267,jämtland,23
5130,5910,780,2018-09-30,86.80 %,0.8680203046,jämtland,23
5147,5935,788,2018-10-31,86.72 %,0.8672283067,jämtland,23
5116,6047,931,2018-11-30,84.60 %,0.8460393584,jämtland,23
6029,7288,1259,2018-12-31,82.73 %,0.8272502744,jämtland,23
5786,6820,1034,2019-01-31,84.84 %,0.8483870968,jämtland,23
5349,6567,1218,2019-02-28,81.45 %,0.8145271814,jämtland,23
5736,6796,1060,2019-03-31,84.40 %,0.8440258976,jämtland,23
5557,6488,931,2019-04-30,85.65 %,0.8565043157,jämtland,23
5130,5950,820,2019-05-31,86.22 %,0.8621848739,jämtland,23
5086,5996,910,2019-06-30,84.82 %,0.8482321548,jämtland,23
5521,6614,1093,2019-07-31,83.47 %,0.8347444814,jämtland,23
5089,5856,767,2019-08-31,86.90 %,0.869023224,jämtland,23
4779,5594,815,2019-09-30,85.43 %,0.8543081873,jämtland,23
4736,5516,780,2019-10-31,85.86 %,0.8585931835,jämtland,23
4819,5673,854,2019-11-30,84.95 %,0.8494623656,jämtland,23
5951,7177,1226,2019-12-31,82.92 %,0.8291765362,jämtland,23
5884,7076,1192,2020-01-31,83.15 %,0.8315432448,jämtland,23
5762,7245,1483,2020-02-29,79.53 %,0.7953071084,jämtland,23
7181,10082,2901,2020-03-31,71.23 %,0.7122594723,jämtland,23
5920,7317,1397,2020-04-30,80.91 %,0.8090747574,jämtland,23
5677,6926,1249,2020-05-31,81.97 %,0.8196650303,jämtland,23
5714,7539,1825,2020-06-30,75.79 %,0.7579254543,jämtland,23
5756,7604,1848,2020-07-31,75.70 %,0.7569700158,jämtland,23
5412,6677,1265,2020-08-31,81.05 %,0.8105436573,jämtland,23
6129,7867,1738,2020-09-30,77.91 %,0.7790771577,jämtland,23
5959,7427,1468,2020-10-31,80.23 %,0.8023428033,jämtland,23
6346,8422,2076,2020-11-30,75.35 %,0.7535027309,jämtland,23
6205,8218,2013,2020-12-31,75.50 %,0.7550498905,jämtland,23
6196,7508,1312,2021-01-31,82.53 %,0.8252530634,jämtland,23
5829,7219,1390,2021-02-28,80.75 %,0.8074525558,jämtland,23
7244,9593,2349,2021-03-31,75.51 %,0.7551339518,jämtland,23
6864,9303,2439,2021-04-30,73.78 %,0.7378265076,jämtland,23
6284,7802,1518,2021-05-31,80.54 %,0.805434504,jämtland,23
5376,6692,1316,2021-06-30,80.33 %,0.8033472803,jämtland,23
5341,7235,1894,2021-07-31,73.82 %,0.7382170007,jämtland,23
5177,6314,1137,2021-08-31,81.99 %,0.8199239785,jämtland,23
5139,6311,1172,2021-09-30,81.43 %,0.8142925051,jämtland,23
5205,6421,1216,2021-10-31,81.06 %,0.8106213985,jämtland,23
5686,7224,1538,2021-11-30,78.71 %,0.7870985604,jämtland,23
6195,8165,1970,2021-12-31,75.87 %,0.7587262707,jämtland,23
3050,3306,256,2017-01-31,92.26 %,0.9225650333,gotland,9
3121,3434,313,2017-02-28,90.89 %,0.90885265,gotland,9
3062,3313,251,2017-03-31,92.42 %,0.9242378509,gotland,9
3068,3337,269,2017-04-30,91.94 %,0.9193886725,gotland,9
3195,3502,307,2017-05-31,91.23 %,0.9123358081,gotland,9
3534,3889,355,2017-06-30,90.87 %,0.9087168938,gotland,9
5310,5874,564,2017-07-31,90.40 %,0.9039836568,gotland,9
3970,4342,372,2017-08-31,91.43 %,0.9143251958,gotland,9
3107,3402,295,2017-09-30,91.33 %,0.9132863022,gotland,9
2999,3300,301,2017-10-31,90.88 %,0.9087878788,gotland,9
3055,3323,268,2017-11-30,91.93 %,0.919349985,gotland,9
3183,3456,273,2017-12-31,92.10 %,0.9210069444,gotland,9
3256,3553,297,2018-01-31,91.64 %,0.9164086687,gotland,9
3040,3298,258,2018-02-28,92.18 %,0.9217707702,gotland,9
3492,3812,320,2018-03-31,91.61 %,0.9160545645,gotland,9
3373,3640,267,2018-04-30,92.66 %,0.9266483516,gotland,9
3383,3738,355,2018-05-31,90.50 %,0.9050294275,gotland,9
3664,4054,390,2018-06-30,90.38 %,0.9037987173,gotland,9
4991,5921,930,2018-07-31,84.29 %,0.8429319372,gotland,9
4039,4436,397,2018-08-31,91.05 %,0.9105049594,gotland,9
2824,3104,280,2018-09-30,90.98 %,0.9097938144,gotland,9
3083,3435,352,2018-10-31,89.75 %,0.8975254731,gotland,9
2831,3165,334,2018-11-30,89.45 %,0.8944707741,gotland,9
2999,3338,339,2018-12-31,89.84 %,0.8984421809,gotland,9
2859,3206,347,2019-01-31,89.18 %,0.8917654398,gotland,9
2584,2937,353,2019-02-28,87.98 %,0.8798093292,gotland,9
2785,3184,399,2019-03-31,87.47 %,0.8746859296,gotland,9
2771,3145,374,2019-04-30,88.11 %,0.8810810811,gotland,9
2872,3219,347,2019-05-31,89.22 %,0.8922025474,gotland,9
3261,3639,378,2019-06-30,89.61 %,0.8961253092,gotland,9
4575,5184,609,2019-07-31,88.25 %,0.8825231481,gotland,9
3465,3862,397,2019-08-31,89.72 %,0.8972035215,gotland,9
2816,3152,336,2019-09-30,89.34 %,0.8934010152,gotland,9
2786,3082,296,2019-10-31,90.40 %,0.9039584685,gotland,9
2698,2982,284,2019-11-30,90.48 %,0.9047619048,gotland,9
2779,3131,352,2019-12-31,88.76 %,0.8875758544,gotland,9
2959,3314,355,2020-01-31,89.29 %,0.8928786964,gotland,9
2617,2913,296,2020-02-29,89.84 %,0.8983865431,gotland,9
3652,4521,869,2020-03-31,80.78 %,0.8077858881,gotland,9
3247,3671,424,2020-04-30,88.45 %,0.8845001362,gotland,9
3118,3501,383,2020-05-31,89.06 %,0.8906026849,gotland,9
3598,4139,541,2020-06-30,86.93 %,0.8692920995,gotland,9
4569,5330,761,2020-07-31,85.72 %,0.8572232645,gotland,9
3744,4288,544,2020-08-31,87.31 %,0.8731343284,gotland,9
3402,3909,507,2020-09-30,87.03 %,0.8702993093,gotland,9
3321,3830,509,2020-10-31,86.71 %,0.8671018277,gotland,9
4377,5176,799,2020-11-30,84.56 %,0.845633694,gotland,9
3505,4020,515,2020-12-31,87.19 %,0.8718905473,gotland,9
3149,3630,481,2021-01-31,86.75 %,0.8674931129,gotland,9
2601,2945,344,2021-02-28,88.32 %,0.8831918506,gotland,9
3155,3668,513,2021-03-31,86.01 %,0.8601417666,gotland,9
3584,4281,697,2021-04-30,83.72 %,0.837187573,gotland,9
3282,3872,590,2021-05-31,84.76 %,0.8476239669,gotland,9
3450,4038,588,2021-06-30,85.44 %,0.8543833581,gotland,9
4883,5900,1017,2021-07-31,82.76 %,0.8276271186,gotland,9
3760,4408,648,2021-08-31,85.30 %,0.8529945554,gotland,9
3066,3585,519,2021-09-30,85.52 %,0.8552301255,gotland,9
2965,3529,564,2021-10-31,84.02 %,0.8401813545,gotland,9
2923,3640,717,2021-11-30,80.30 %,0.803021978,gotland,9
3060,3845,785,2021-12-31,79.58 %,0.7958387516,gotland,9
9369,11246,1877,2017-01-31,83.31 %,0.833096212,kronoberg,7
8467,10878,2411,2017-02-28,77.84 %,0.7783599926,kronoberg,7
8895,10812,1917,2017-03-31,82.27 %,0.8226970033,kronoberg,7
8410,9935,1525,2017-04-30,84.65 %,0.8465022647,kronoberg,7
8591,10610,2019,2017-05-31,80.97 %,0.8097078228,kronoberg,7
7616,9769,2153,2017-06-30,77.96 %,0.7796089671,kronoberg,7
7275,9506,2231,2017-07-31,76.53 %,0.7653061224,kronoberg,7
7599,9600,2001,2017-08-31,79.16 %,0.7915625,kronoberg,7
8016,9601,1585,2017-09-30,83.49 %,0.8349130299,kronoberg,7
8292,10621,2329,2017-10-31,78.07 %,0.7807174466,kronoberg,7
8000,10162,2162,2017-11-30,78.72 %,0.787246605,kronoberg,7
7939,9951,2012,2017-12-31,79.78 %,0.7978092654,kronoberg,7
8386,11085,2699,2018-01-31,75.65 %,0.7565178169,kronoberg,7
7911,10950,3039,2018-02-28,72.25 %,0.7224657534,kronoberg,7
8698,12455,3757,2018-03-31,69.84 %,0.6983540747,kronoberg,7
8030,10952,2922,2018-04-30,73.32 %,0.7331994156,kronoberg,7
8299,10832,2533,2018-05-31,76.62 %,0.7661558346,kronoberg,7
7822,10163,2341,2018-06-30,76.97 %,0.7696546295,kronoberg,7
7357,10391,3034,2018-07-31,70.80 %,0.7080165528,kronoberg,7
7470,9576,2106,2018-08-31,78.01 %,0.780075188,kronoberg,7
7627,9145,1518,2018-09-30,83.40 %,0.8340076545,kronoberg,7
8277,9884,1607,2018-10-31,83.74 %,0.8374140024,kronoberg,7
7771,9367,1596,2018-11-30,82.96 %,0.8296146045,kronoberg,7
7893,9462,1569,2018-12-31,83.42 %,0.8341788205,kronoberg,7
8097,9733,1636,2019-01-31,83.19 %,0.8319120518,kronoberg,7
7206,8984,1778,2019-02-28,80.21 %,0.8020926091,kronoberg,7
8174,9618,1444,2019-03-31,84.99 %,0.8498648368,kronoberg,7
7921,9239,1318,2019-04-30,85.73 %,0.8573438684,kronoberg,7
7878,9274,1396,2019-05-31,84.95 %,0.8494716411,kronoberg,7
7339,8920,1581,2019-06-30,82.28 %,0.8227578475,kronoberg,7
6868,8244,1376,2019-07-31,83.31 %,0.8330907327,kronoberg,7
7344,8633,1289,2019-08-31,85.07 %,0.8506892158,kronoberg,7
7635,8943,1308,2019-09-30,85.37 %,0.8537403556,kronoberg,7
7953,9493,1540,2019-10-31,83.78 %,0.8377752028,kronoberg,7
7728,9195,1467,2019-11-30,84.05 %,0.84045677,kronoberg,7
7751,9325,1574,2019-12-31,83.12 %,0.8312064343,kronoberg,7
7837,9399,1562,2020-01-31,83.38 %,0.8338121077,kronoberg,7
7700,9879,2179,2020-02-29,77.94 %,0.7794311165,kronoberg,7
9573,13290,3717,2020-03-31,72.03 %,0.7203160271,kronoberg,7
8134,10073,1939,2020-04-30,80.75 %,0.807505212,kronoberg,7
7949,9348,1399,2020-05-31,85.03 %,0.8503423192,kronoberg,7
7345,9309,1964,2020-06-30,78.90 %,0.7890213772,kronoberg,7
6941,8527,1586,2020-07-31,81.40 %,0.81400258,kronoberg,7
7999,9897,1898,2020-08-31,80.82 %,0.8082247146,kronoberg,7
8288,10216,1928,2020-09-30,81.13 %,0.8112764291,kronoberg,7
8386,10381,1995,2020-10-31,80.78 %,0.8078219825,kronoberg,7
8537,11151,2614,2020-11-30,76.56 %,0.7655815622,kronoberg,7
8337,10488,2151,2020-12-31,79.49 %,0.7949084668,kronoberg,7
8599,10390,1791,2021-01-31,82.76 %,0.8276227141,kronoberg,7
7972,9447,1475,2021-02-28,84.39 %,0.8438657775,kronoberg,7
8888,11118,2230,2021-03-31,79.94 %,0.7994243569,kronoberg,7
9511,12709,3198,2021-04-30,74.84 %,0.7483672988,kronoberg,7
9286,12257,2971,2021-05-31,75.76 %,0.7576078975,kronoberg,7
8520,10530,2010,2021-06-30,80.91 %,0.8091168091,kronoberg,7
7528,9454,1926,2021-07-31,79.63 %,0.7962767083,kronoberg,7
7722,9689,1967,2021-08-31,79.70 %,0.7969862731,kronoberg,7
8364,10223,1859,2021-09-30,81.82 %,0.8181551404,kronoberg,7
8676,10921,2245,2021-10-31,79.44 %,0.7944327443,kronoberg,7
8313,10858,2545,2021-11-30,76.56 %,0.7656106097,kronoberg,7
8389,10796,2407,2021-12-31,77.70 %,0.7770470545,kronoberg,7
2378,3203,825,2018-02-28,74.24 %,0.7424289728,norrbotten,25
8021,11577,3556,2018-03-31,69.28 %,0.6928392502,norrbotten,25
7605,10403,2798,2018-04-30,73.10 %,0.7310391233,norrbotten,25
7544,10215,2671,2018-05-31,73.85 %,0.7385217817,norrbotten,25
7598,9852,2254,2018-06-30,77.12 %,0.7712139667,norrbotten,25
7375,11558,4183,2018-07-31,63.81 %,0.6380861741,norrbotten,25
6701,9572,2871,2018-08-31,70.01 %,0.7000626828,norrbotten,25
7026,9572,2546,2018-09-30,73.40 %,0.7340158796,norrbotten,25
7367,10335,2968,2018-10-31,71.28 %,0.7128205128,norrbotten,25
7216,9723,2507,2018-11-30,74.22 %,0.7421577702,norrbotten,25
7610,9985,2375,2018-12-31,76.21 %,0.7621432148,norrbotten,25
7154,9045,1891,2019-01-31,79.09 %,0.7909342178,norrbotten,25
6627,8569,1942,2019-02-28,77.34 %,0.7733691213,norrbotten,25
7639,9325,1686,2019-03-31,81.92 %,0.8191957105,norrbotten,25
7353,9065,1712,2019-04-30,81.11 %,0.811141754,norrbotten,25
7951,9399,1448,2019-05-31,84.59 %,0.8459410576,norrbotten,25
7661,9357,1696,2019-06-30,81.87 %,0.8187453244,norrbotten,25
7253,9036,1783,2019-07-31,80.27 %,0.8026781762,norrbotten,25
6766,8227,1461,2019-08-31,82.24 %,0.8224140027,norrbotten,25
7305,8810,1505,2019-09-30,82.92 %,0.8291713961,norrbotten,25
7200,8720,1520,2019-10-31,82.57 %,0.8256880734,norrbotten,25
7247,8920,1673,2019-11-30,81.24 %,0.8124439462,norrbotten,25
7983,9926,1943,2019-12-31,80.43 %,0.8042514608,norrbotten,25
8138,9986,1848,2020-01-31,81.49 %,0.8149409173,norrbotten,25
7639,10184,2545,2020-02-29,75.01 %,0.7500981932,norrbotten,25
8882,12755,3873,2020-03-31,69.64 %,0.6963543708,norrbotten,25
8358,10818,2460,2020-04-30,77.26 %,0.7726012202,norrbotten,25
7948,9745,1797,2020-05-31,81.56 %,0.8155977424,norrbotten,25
7930,10497,2567,2020-06-30,75.55 %,0.7554539392,norrbotten,25
7111,9466,2355,2020-07-31,75.12 %,0.7512148743,norrbotten,25
7602,9591,1989,2020-08-31,79.26 %,0.7926180794,norrbotten,25
7921,10207,2286,2020-09-30,77.60 %,0.7760360537,norrbotten,25
7900,9937,2037,2020-10-31,79.50 %,0.7950085539,norrbotten,25
9870,14193,4323,2020-11-30,69.54 %,0.6954132319,norrbotten,25
9008,11592,2584,2020-12-31,77.71 %,0.7770876467,norrbotten,25
8295,10579,2284,2021-01-31,78.41 %,0.7841005766,norrbotten,25
8228,10785,2557,2021-02-28,76.29 %,0.7629114511,norrbotten,25
10127,14100,3973,2021-03-31,71.82 %,0.7182269504,norrbotten,25
10426,14342,3916,2021-04-30,72.70 %,0.7269557942,norrbotten,25
9885,12418,2533,2021-05-31,79.60 %,0.7960219037,norrbotten,25
8837,10903,2066,2021-06-30,81.05 %,0.8105108686,norrbotten,25
7632,10146,2514,2021-07-31,75.22 %,0.7522176227,norrbotten,25
7828,9712,1884,2021-08-31,80.60 %,0.8060131796,norrbotten,25
7990,9848,1858,2021-09-30,81.13 %,0.8113322502,norrbotten,25
8050,10199,2149,2021-10-31,78.93 %,0.7892930679,norrbotten,25
8756,11097,2341,2021-11-30,78.90 %,0.7890420834,norrbotten,25
8877,11358,2481,2021-12-31,78.16 %,0.7815636556,norrbotten,25
7763,9251,1488,2017-01-31,83.92 %,0.8391525241,blekinge,10
7265,8974,1709,2017-02-28,80.96 %,0.8095609539,blekinge,10
7923,9475,1552,2017-03-31,83.62 %,0.8362005277,blekinge,10
7291,8739,1448,2017-04-30,83.43 %,0.8343059847,blekinge,10
7845,9788,1943,2017-05-31,80.15 %,0.8014916224,blekinge,10
7346,9228,1882,2017-06-30,79.61 %,0.7960554833,blekinge,10
6931,9137,2206,2017-07-31,75.86 %,0.7585640801,blekinge,10
6628,7763,1135,2017-08-31,85.38 %,0.8537936365,blekinge,10
6986,8469,1483,2017-09-30,82.49 %,0.8248907781,blekinge,10
6962,8664,1702,2017-10-31,80.36 %,0.80355494,blekinge,10
6473,7870,1397,2017-11-30,82.25 %,0.8224904701,blekinge,10
6767,8407,1640,2017-12-31,80.49 %,0.8049244677,blekinge,10
6832,8703,1871,2018-01-31,78.50 %,0.7850166609,blekinge,10
6459,8928,2469,2018-02-28,72.35 %,0.7234543011,blekinge,10
7261,10189,2928,2018-03-31,71.26 %,0.712631269,blekinge,10
6831,8926,2095,2018-04-30,76.53 %,0.7652924042,blekinge,10
6536,8253,1717,2018-05-31,79.20 %,0.7919544408,blekinge,10
6458,8136,1678,2018-06-30,79.38 %,0.7937561455,blekinge,10
6037,8366,2329,2018-07-31,72.16 %,0.7216112838,blekinge,10
6143,7722,1579,2018-08-31,79.55 %,0.7955192955,blekinge,10
6191,7344,1153,2018-09-30,84.30 %,0.8430010893,blekinge,10
6310,7453,1143,2018-10-31,84.66 %,0.8466389373,blekinge,10
5979,7125,1146,2018-11-30,83.92 %,0.8391578947,blekinge,10
6533,7684,1151,2018-12-31,85.02 %,0.8502082249,blekinge,10
6391,7454,1063,2019-01-31,85.74 %,0.8573920043,blekinge,10
5505,6644,1139,2019-02-28,82.86 %,0.8285671282,blekinge,10
6410,7398,988,2019-03-31,86.65 %,0.866450392,blekinge,10
6942,8007,1065,2019-04-30,86.70 %,0.8669913825,blekinge,10
6540,7359,819,2019-05-31,88.87 %,0.8887077049,blekinge,10
6828,7816,988,2019-06-30,87.36 %,0.8735926305,blekinge,10
6614,7757,1143,2019-07-31,85.26 %,0.8526492201,blekinge,10
6385,7196,811,2019-08-31,88.73 %,0.8872984992,blekinge,10
6470,7271,801,2019-09-30,88.98 %,0.8898363361,blekinge,10
6177,6853,676,2019-10-31,90.14 %,0.9013570699,blekinge,10
6517,7366,849,2019-11-30,88.47 %,0.8847407005,blekinge,10
6588,7518,930,2019-12-31,87.63 %,0.8762968875,blekinge,10
6466,7366,900,2020-01-31,87.78 %,0.877816997,blekinge,10
6517,7851,1334,2020-02-29,83.01 %,0.8300853394,blekinge,10
7604,10347,2743,2020-03-31,73.49 %,0.7348990045,blekinge,10
6386,7493,1107,2020-04-30,85.23 %,0.8522621113,blekinge,10
6475,7360,885,2020-05-31,87.98 %,0.8797554348,blekinge,10
6389,7750,1361,2020-06-30,82.44 %,0.8243870968,blekinge,10
6347,7707,1360,2020-07-31,82.35 %,0.8235370442,blekinge,10
6698,7848,1150,2020-08-31,85.35 %,0.8534658512,blekinge,10
6962,8380,1418,2020-09-30,83.08 %,0.8307875895,blekinge,10
6697,8103,1406,2020-10-31,82.65 %,0.8264840183,blekinge,10
7022,9010,1988,2020-11-30,77.94 %,0.7793562708,blekinge,10
7290,9136,1846,2020-12-31,79.79 %,0.7979422067,blekinge,10
7022,8302,1280,2021-01-31,84.58 %,0.8458202843,blekinge,10
5837,6796,959,2021-02-28,85.89 %,0.8588875809,blekinge,10
7065,8574,1509,2021-03-31,82.40 %,0.8240027992,blekinge,10
7938,10404,2466,2021-04-30,76.30 %,0.7629757785,blekinge,10
7353,9297,1944,2021-05-31,79.09 %,0.7909002904,blekinge,10
6985,8642,1657,2021-06-30,80.83 %,0.8082619764,blekinge,10
7370,9244,1874,2021-07-31,79.73 %,0.7972739074,blekinge,10
6240,7689,1449,2021-08-31,81.15 %,0.8115489661,blekinge,10
6669,8063,1394,2021-09-30,82.71 %,0.827111497,blekinge,10
6766,8328,1562,2021-10-31,81.24 %,0.8124399616,blekinge,10
6931,8818,1887,2021-11-30,78.60 %,0.786005897,blekinge,10
7077,8987,1910,2021-12-31,78.75 %,0.7874707911,blekinge,10
14506,16691,2185,2017-01-31,86.91 %,0.869091127,västerbotten,24
12511,14796,2285,2017-02-28,84.56 %,0.8455663693,västerbotten,24
12757,14615,1858,2017-03-31,87.29 %,0.8728703387,västerbotten,24
12337,13921,1584,2017-04-30,88.62 %,0.8862150708,västerbotten,24
12801,14362,1561,2017-05-31,89.13 %,0.8913104025,västerbotten,24
12022,13602,1580,2017-06-30,88.38 %,0.8838406117,västerbotten,24
11655,13510,1855,2017-07-31,86.27 %,0.8626943005,västerbotten,24
10749,11839,1090,2017-08-31,90.79 %,0.9079314131,västerbotten,24
11343,12881,1538,2017-09-30,88.06 %,0.8805993323,västerbotten,24
12282,14213,1931,2017-10-31,86.41 %,0.8641384648,västerbotten,24
12146,14065,1919,2017-11-30,86.36 %,0.8635620334,västerbotten,24
12721,14632,1911,2017-12-31,86.94 %,0.8693958447,västerbotten,24
12654,15430,2776,2018-01-31,82.01 %,0.8200907323,västerbotten,24
11480,14704,3224,2018-02-28,78.07 %,0.7807399347,västerbotten,24
11713,15773,4060,2018-03-31,74.26 %,0.7425981107,västerbotten,24
11093,14363,3270,2018-04-30,77.23 %,0.7723316856,västerbotten,24
11414,14462,3048,2018-05-31,78.92 %,0.7892407689,västerbotten,24
11141,13806,2665,2018-06-30,80.70 %,0.8069679849,västerbotten,24
11188,15160,3972,2018-07-31,73.80 %,0.737994723,västerbotten,24
10861,13094,2233,2018-08-31,82.95 %,0.8294638766,västerbotten,24
10972,13042,2070,2018-09-30,84.13 %,0.841282012,västerbotten,24
11407,13742,2335,2018-10-31,83.01 %,0.8300829574,västerbotten,24
11572,14244,2672,2018-11-30,81.24 %,0.8124122438,västerbotten,24
11896,14540,2644,2018-12-31,81.82 %,0.8181568088,västerbotten,24
12064,14424,2360,2019-01-31,83.64 %,0.8363838048,västerbotten,24
10521,13048,2527,2019-02-28,80.63 %,0.8063304721,västerbotten,24
11786,14230,2444,2019-03-31,82.83 %,0.8282501757,västerbotten,24
11142,13180,2038,2019-04-30,84.54 %,0.8453717754,västerbotten,24
10857,12928,2071,2019-05-31,83.98 %,0.8398050743,västerbotten,24
10576,12583,2007,2019-06-30,84.05 %,0.8404990861,västerbotten,24
9945,11877,1932,2019-07-31,83.73 %,0.8373326598,västerbotten,24
9979,11399,1420,2019-08-31,87.54 %,0.8754276691,västerbotten,24
10416,12009,1593,2019-09-30,86.73 %,0.8673494879,västerbotten,24
10659,12521,1862,2019-10-31,85.13 %,0.8512898331,västerbotten,24
11466,13547,2081,2019-11-30,84.64 %,0.8463866539,västerbotten,24
11687,14089,2402,2019-12-31,82.95 %,0.8295123855,västerbotten,24
11757,14087,2330,2020-01-31,83.46 %,0.8345992759,västerbotten,24
11484,14637,3153,2020-02-29,78.46 %,0.7845870055,västerbotten,24
12621,17344,4723,2020-03-31,72.77 %,0.7276868081,västerbotten,24
11263,13791,2528,2020-04-30,81.67 %,0.8166920455,västerbotten,24
10960,13129,2169,2020-05-31,83.48 %,0.8347932059,västerbotten,24
10513,13235,2722,2020-06-30,79.43 %,0.7943332074,västerbotten,24
10285,13111,2826,2020-07-31,78.45 %,0.7844558005,västerbotten,24
10318,12995,2677,2020-08-31,79.40 %,0.7939976914,västerbotten,24
10478,13648,3170,2020-09-30,76.77 %,0.7677315358,västerbotten,24
10572,13296,2724,2020-10-31,79.51 %,0.7951263538,västerbotten,24
11583,15774,4191,2020-11-30,73.43 %,0.7343096234,västerbotten,24
11059,14098,3039,2020-12-31,78.44 %,0.7844375089,västerbotten,24
10381,12937,2556,2021-01-31,80.24 %,0.8024271469,västerbotten,24
10323,13018,2695,2021-02-28,79.30 %,0.7929789522,västerbotten,24
12483,15939,3456,2021-03-31,78.32 %,0.7831733484,västerbotten,24
11799,15540,3741,2021-04-30,75.93 %,0.7592664093,västerbotten,24
12322,15459,3137,2021-05-31,79.71 %,0.7970761369,västerbotten,24
10986,13842,2856,2021-06-30,79.37 %,0.7936714348,västerbotten,24
10430,13752,3322,2021-07-31,75.84 %,0.7584351367,västerbotten,24
10121,13577,3456,2021-08-31,74.55 %,0.7454518671,västerbotten,24
10515,13456,2941,2021-09-30,78.14 %,0.7814357907,västerbotten,24
11552,14480,2928,2021-10-31,79.78 %,0.7977900552,västerbotten,24
10737,14195,3458,2021-11-30,75.64 %,0.7563930962,västerbotten,24
10540,13658,3118,2021-12-31,77.17 %,0.7717088886,västerbotten,24
32135,49954,17819,2017-01-31,64.33 %,0.6432918285,skåne,12
28510,48860,20350,2017-02-28,58.35 %,0.5835038887,skåne,12
28900,51158,22258,2017-03-31,56.49 %,0.5649165331,skåne,12
25798,47168,21370,2017-04-30,54.69 %,0.5469386024,skåne,12
26070,47828,21758,2017-05-31,54.51 %,0.5450781969,skåne,12
26773,42773,16000,2017-06-30,62.59 %,0.625932247,skåne,12
24499,41841,17342,2017-07-31,58.55 %,0.5855261586,skåne,12
26736,40874,14138,2017-08-31,65.41 %,0.6541077458,skåne,12
24423,40160,15737,2017-09-30,60.81 %,0.6081424303,skåne,12
24956,42016,17060,2017-10-31,59.40 %,0.5939642041,skåne,12
26254,40571,14317,2017-11-30,64.71 %,0.6471124695,skåne,12
26390,43795,17405,2017-12-31,60.26 %,0.6025802032,skåne,12
25988,46045,20057,2018-01-31,56.44 %,0.564404387,skåne,12
22512,43180,20668,2018-02-28,52.14 %,0.521352478,skåne,12
24650,47866,23216,2018-03-31,51.50 %,0.5149793173,skåne,12
23926,42953,19027,2018-04-30,55.70 %,0.5570274486,skåne,12
24785,43446,18661,2018-05-31,57.05 %,0.5704782949,skåne,12
24115,42113,17998,2018-06-30,57.26 %,0.57262603,skåne,12
22835,41123,18288,2018-07-31,55.53 %,0.5552853634,skåne,12
23486,39711,16225,2018-08-31,59.14 %,0.5914230314,skåne,12
23123,38076,14953,2018-09-30,60.73 %,0.6072854291,skåne,12
24826,38981,14155,2018-10-31,63.69 %,0.6368743747,skåne,12
24676,37825,13149,2018-11-30,65.24 %,0.6523727693,skåne,12
25055,35349,10294,2018-12-31,70.88 %,0.708789499,skåne,12
26834,37021,10187,2019-01-31,72.48 %,0.7248318522,skåne,12
23864,34167,10303,2019-02-28,69.85 %,0.6984517224,skåne,12
25198,35417,10219,2019-03-31,71.15 %,0.711466245,skåne,12
24957,34821,9864,2019-04-30,71.67 %,0.7167226674,skåne,12
25406,35742,10336,2019-05-31,71.08 %,0.7108164065,skåne,12
24875,34502,9627,2019-06-30,72.10 %,0.7209726972,skåne,12
24369,33512,9143,2019-07-31,72.72 %,0.7271723562,skåne,12
25246,33722,8476,2019-08-31,74.87 %,0.7486507325,skåne,12
24276,33137,8861,2019-09-30,73.26 %,0.7325949845,skåne,12
26556,35260,8704,2019-10-31,75.31 %,0.7531480431,skåne,12
26025,35063,9038,2019-11-30,74.22 %,0.7422354048,skåne,12
24682,34783,10101,2019-12-31,70.96 %,0.709599517,skåne,12
26821,36623,9802,2020-01-31,73.24 %,0.7323539852,skåne,12
25458,37256,11798,2020-02-29,68.33 %,0.6833261756,skåne,12
33148,63818,30670,2020-03-31,51.94 %,0.5194145852,skåne,12
31078,43538,12460,2020-04-30,71.38 %,0.7138132206,skåne,12
30722,41821,11099,2020-05-31,73.46 %,0.7346070156,skåne,12
26076,41130,15054,2020-06-30,63.40 %,0.6339897885,skåne,12
25560,38789,13229,2020-07-31,65.89 %,0.6589497022,skåne,12
28858,44139,15281,2020-08-31,65.38 %,0.6537982283,skåne,12
28204,45812,17608,2020-09-30,61.56 %,0.6156465555,skåne,12
30045,46207,16162,2020-10-31,65.02 %,0.6502261562,skåne,12
30654,54984,24330,2020-11-30,55.75 %,0.5575076386,skåne,12
34847,58476,23629,2020-12-31,59.59 %,0.5959196935,skåne,12
32358,49741,17383,2021-01-31,65.05 %,0.6505297441,skåne,12
27008,39813,12805,2021-02-28,67.84 %,0.6783713862,skåne,12
29170,46539,17369,2021-03-31,62.68 %,0.6267861364,skåne,12
27105,50064,22959,2021-04-30,54.14 %,0.541406999,skåne,12
27443,48772,21329,2021-05-31,56.27 %,0.5626794062,skåne,12
24829,40889,16060,2021-06-30,60.72 %,0.6072293282,skåne,12
21908,40883,18975,2021-07-31,53.59 %,0.5358706553,skåne,12
23054,38574,15520,2021-08-31,59.77 %,0.5976564525,skåne,12
23241,38946,15705,2021-09-30,59.67 %,0.5967493452,skåne,12
23613,43941,20328,2021-10-31,53.74 %,0.5373796682,skåne,12
23126,35248,12122,2021-11-30,65.61 %,0.6560939628,skåne,12
24899,38913,14014,2021-12-31,63.99 %,0.6398632848,skåne,12
12737,17080,4343,2017-01-31,74.57 %,0.7457259953,gävleborg,21
11033,16348,5315,2017-02-28,67.49 %,0.6748837778,gävleborg,21
11700,16724,5024,2017-03-31,69.96 %,0.6995933987,gävleborg,21
11815,16339,4524,2017-04-30,72.31 %,0.7231164698,gävleborg,21
11712,16118,4406,2017-05-31,72.66 %,0.7266410225,gävleborg,21
11299,15148,3849,2017-06-30,74.59 %,0.7459070504,gävleborg,21
10886,14847,3961,2017-07-31,73.32 %,0.7332120967,gävleborg,21
11195,13497,2302,2017-08-31,82.94 %,0.8294435801,gävleborg,21
11248,13677,2429,2017-09-30,82.24 %,0.8224025737,gävleborg,21
12052,14402,2350,2017-10-31,83.68 %,0.8368282183,gävleborg,21
11500,13739,2239,2017-11-30,83.70 %,0.837033263,gävleborg,21
12206,15312,3106,2017-12-31,79.72 %,0.7971525601,gävleborg,21
12318,16613,4295,2018-01-31,74.15 %,0.7414675254,gävleborg,21
10420,14792,4372,2018-02-28,70.44 %,0.7044348296,gävleborg,21
11256,16342,5086,2018-03-31,68.88 %,0.6887773834,gävleborg,21
10954,15122,4168,2018-04-30,72.44 %,0.7243750827,gävleborg,21
10505,15993,5488,2018-05-31,65.68 %,0.6568498718,gävleborg,21
9615,14988,5373,2018-06-30,64.15 %,0.6415132106,gävleborg,21
9892,16026,6134,2018-07-31,61.72 %,0.6172469737,gävleborg,21
9606,14491,4885,2018-08-31,66.29 %,0.6628942102,gävleborg,21
9234,14109,4875,2018-09-30,65.45 %,0.6544758665,gävleborg,21
9440,13929,4489,2018-10-31,67.77 %,0.6777227367,gävleborg,21
9349,13289,3940,2018-11-30,70.35 %,0.7035141847,gävleborg,21
9943,13305,3362,2018-12-31,74.73 %,0.7473130402,gävleborg,21
10334,13696,3362,2019-01-31,75.45 %,0.7545268692,gävleborg,21
9364,12548,3184,2019-02-28,74.63 %,0.7462543832,gävleborg,21
9688,12964,3276,2019-03-31,74.73 %,0.747300216,gävleborg,21
9443,12531,3088,2019-04-30,75.36 %,0.7535711436,gävleborg,21
9701,12662,2961,2019-05-31,76.62 %,0.7661506871,gävleborg,21
9170,12527,3357,2019-06-30,73.20 %,0.7320188393,gävleborg,21
8538,11696,3158,2019-07-31,73.00 %,0.7299931601,gävleborg,21
8805,11622,2817,2019-08-31,75.76 %,0.7576148684,gävleborg,21
9166,11724,2558,2019-09-30,78.18 %,0.7818150802,gävleborg,21
9561,11983,2422,2019-10-31,79.79 %,0.7978803305,gävleborg,21
9153,11798,2645,2019-11-30,77.58 %,0.7758094592,gävleborg,21
10519,13746,3227,2019-12-31,76.52 %,0.7652407973,gävleborg,21
9903,13016,3113,2020-01-31,76.08 %,0.7608328211,gävleborg,21
9031,12469,3438,2020-02-29,72.43 %,0.724276205,gävleborg,21
9300,16930,7630,2020-03-31,54.93 %,0.5493207324,gävleborg,21
10083,14557,4474,2020-04-30,69.27 %,0.6926564539,gävleborg,21
9814,13538,3724,2020-05-31,72.49 %,0.7249224405,gävleborg,21
10457,15843,5386,2020-06-30,66.00 %,0.660039134,gävleborg,21
10397,15027,4630,2020-07-31,69.19 %,0.6918879351,gävleborg,21
9868,13833,3965,2020-08-31,71.34 %,0.7133665871,gävleborg,21
10335,15328,4993,2020-09-30,67.43 %,0.674256263,gävleborg,21
9464,13145,3681,2020-10-31,72.00 %,0.7199695702,gävleborg,21
9765,15997,6232,2020-11-30,61.04 %,0.6104269551,gävleborg,21
10024,15358,5334,2020-12-31,65.27 %,0.6526891522,gävleborg,21
9858,13845,3987,2021-01-31,71.20 %,0.7120260022,gävleborg,21
9157,12511,3354,2021-02-28,73.19 %,0.731915914,gävleborg,21
9941,15902,5961,2021-03-31,62.51 %,0.6251414916,gävleborg,21
8919,15554,6635,2021-04-30,57.34 %,0.5734216279,gävleborg,21
8933,14158,5225,2021-05-31,63.10 %,0.6309506993,gävleborg,21
8530,13150,4620,2021-06-30,64.87 %,0.6486692015,gävleborg,21
7494,13193,5699,2021-07-31,56.80 %,0.5680285,gävleborg,21
7748,12020,4272,2021-08-31,64.46 %,0.6445923461,gävleborg,21
7980,12200,4220,2021-09-30,65.41 %,0.6540983607,gävleborg,21
8072,13588,5516,2021-10-31,59.41 %,0.5940535767,gävleborg,21
7475,11737,4262,2021-11-30,63.69 %,0.6368748402,gävleborg,21
7499,12150,4651,2021-12-31,61.72 %,0.6172016461,gävleborg,21
7112,9973,2861,2017-01-31,71.31 %,0.7131254387,kalmar,8
6207,9406,3199,2017-02-28,65.99 %,0.6598979375,kalmar,8
6673,10223,3550,2017-03-31,65.27 %,0.652743813,kalmar,8
6089,9434,3345,2017-04-30,64.54 %,0.6454314183,kalmar,8
6735,11573,4838,2017-05-31,58.20 %,0.5819580057,kalmar,8
6740,11869,5129,2017-06-30,56.79 %,0.5678658691,kalmar,8
7431,13369,5938,2017-07-31,55.58 %,0.555838133,kalmar,8
7126,10956,3830,2017-08-31,65.04 %,0.6504198613,kalmar,8
6462,10447,3985,2017-09-30,61.86 %,0.6185507801,kalmar,8
6371,10410,4039,2017-10-31,61.20 %,0.6120076849,kalmar,8
6327,9690,3363,2017-11-30,65.29 %,0.6529411765,kalmar,8
6550,10376,3826,2017-12-31,63.13 %,0.6312644564,kalmar,8
6878,11687,4809,2018-01-31,58.85 %,0.5885171558,kalmar,8
5700,11446,5746,2018-02-28,49.80 %,0.4979905644,kalmar,8
6160,11851,5691,2018-03-31,51.98 %,0.5197873597,kalmar,8
6681,11426,4745,2018-04-30,58.47 %,0.5847190618,kalmar,8
7209,11707,4498,2018-05-31,61.58 %,0.6157854275,kalmar,8
6752,11417,4665,2018-06-30,59.14 %,0.5913987913,kalmar,8
7793,14340,6547,2018-07-31,54.34 %,0.5434449093,kalmar,8
7449,12251,4802,2018-08-31,60.80 %,0.6080319974,kalmar,8
6127,9891,3764,2018-09-30,61.95 %,0.6194520271,kalmar,8
6316,9861,3545,2018-10-31,64.05 %,0.6405029916,kalmar,8
6370,9478,3108,2018-11-30,67.21 %,0.6720827179,kalmar,8
5886,9224,3338,2018-12-31,63.81 %,0.6381179532,kalmar,8
6423,9671,3248,2019-01-31,66.42 %,0.6641505532,kalmar,8
5528,8895,3367,2019-02-28,62.15 %,0.6214727375,kalmar,8
5834,9203,3369,2019-03-31,63.39 %,0.6339237205,kalmar,8
5865,9060,3195,2019-04-30,64.74 %,0.6473509934,kalmar,8
6399,9624,3225,2019-05-31,66.49 %,0.6649002494,kalmar,8
6346,9616,3270,2019-06-30,65.99 %,0.6599417637,kalmar,8
7200,10723,3523,2019-07-31,67.15 %,0.6714538842,kalmar,8
6668,9391,2723,2019-08-31,71.00 %,0.7100415291,kalmar,8
6854,9444,2590,2019-09-30,72.58 %,0.7257518001,kalmar,8
7009,9320,2311,2019-10-31,75.20 %,0.7520386266,kalmar,8
6847,9191,2344,2019-11-30,74.50 %,0.7449679034,kalmar,8
7116,9944,2828,2019-12-31,71.56 %,0.7156074014,kalmar,8
6949,9741,2792,2020-01-31,71.34 %,0.7133764501,kalmar,8
6231,9320,3089,2020-02-29,66.86 %,0.6685622318,kalmar,8
6850,13123,6273,2020-03-31,52.20 %,0.5219843024,kalmar,8
7700,11044,3344,2020-04-30,69.72 %,0.6972111554,kalmar,8
7698,10531,2833,2020-05-31,73.10 %,0.7309847118,kalmar,8
7354,11297,3943,2020-06-30,65.10 %,0.6509692839,kalmar,8
7924,11884,3960,2020-07-31,66.68 %,0.6667788623,kalmar,8
7646,11440,3794,2020-08-31,66.84 %,0.6683566434,kalmar,8
7168,10998,3830,2020-09-30,65.18 %,0.6517548645,kalmar,8
7069,10313,3244,2020-10-31,68.54 %,0.6854455542,kalmar,8
7507,12679,5172,2020-11-30,59.21 %,0.5920813944,kalmar,8
7189,11415,4226,2020-12-31,62.98 %,0.6297853701,kalmar,8
7691,11031,3340,2021-01-31,69.72 %,0.6972169341,kalmar,8
6773,9732,2959,2021-02-28,69.60 %,0.6959515002,kalmar,8
7619,12734,5115,2021-03-31,59.83 %,0.5983194597,kalmar,8
8268,15673,7405,2021-04-30,52.75 %,0.5275314235,kalmar,8
7127,12207,5080,2021-05-31,58.38 %,0.5838453346,kalmar,8
7221,11695,4474,2021-06-30,61.74 %,0.6174433519,kalmar,8
7519,13657,6138,2021-07-31,55.06 %,0.5505601523,kalmar,8
6535,10773,4238,2021-08-31,60.66 %,0.6066091154,kalmar,8
6227,9697,3470,2021-09-30,64.22 %,0.6421573683,kalmar,8
6215,10702,4487,2021-10-31,58.07 %,0.5807325734,kalmar,8
6325,9667,3342,2021-11-30,65.43 %,0.6542877832,kalmar,8
6114,9828,3714,2021-12-31,62.21 %,0.6221001221,kalmar,8
18102,27906,9804,2017-01-31,64.87 %,0.6486777037,östergötland,5
15769,25933,10164,2017-02-28,60.81 %,0.6080669417,östergötland,5
17591,27791,10200,2017-03-31,63.30 %,0.632974704,östergötland,5
17079,26914,9835,2017-04-30,63.46 %,0.6345768002,östergötland,5
18367,28296,9929,2017-05-31,64.91 %,0.6491023466,östergötland,5
17675,25968,8293,2017-06-30,68.06 %,0.6806454097,östergötland,5
15894,24340,8446,2017-07-31,65.30 %,0.6529991783,östergötland,5
16143,22188,6045,2017-08-31,72.76 %,0.7275554354,östergötland,5
16690,23442,6752,2017-09-30,71.20 %,0.7119699684,östergötland,5
17354,24685,7331,2017-10-31,70.30 %,0.7030180271,östergötland,5
17018,24103,7085,2017-11-30,70.61 %,0.7060531884,östergötland,5
16935,24610,7675,2017-12-31,68.81 %,0.6881349045,östergötland,5
17672,27521,9849,2018-01-31,64.21 %,0.6421278297,östergötland,5
15379,25675,10296,2018-02-28,59.90 %,0.5989873418,östergötland,5
16958,27863,10905,2018-03-31,60.86 %,0.6086207515,östergötland,5
15869,24965,9096,2018-04-30,63.56 %,0.6356499099,östergötland,5
17335,26061,8726,2018-05-31,66.52 %,0.6651701777,östergötland,5
16958,26031,9073,2018-06-30,65.15 %,0.6514540356,östergötland,5
14903,25466,10563,2018-07-31,58.52 %,0.5852116548,östergötland,5
15932,23920,7988,2018-08-31,66.61 %,0.6660535117,östergötland,5
16363,23910,7547,2018-09-30,68.44 %,0.6843580092,östergötland,5
16804,23651,6847,2018-10-31,71.05 %,0.710498499,östergötland,5
16346,22321,5975,2018-11-30,73.23 %,0.7323148604,östergötland,5
16534,21927,5393,2018-12-31,75.40 %,0.7540475213,östergötland,5
17362,22894,5532,2019-01-31,75.84 %,0.758364637,östergötland,5
14987,20493,5506,2019-02-28,73.13 %,0.7313228907,östergötland,5
15921,21690,5769,2019-03-31,73.40 %,0.7340248963,östergötland,5
15447,20752,5305,2019-04-30,74.44 %,0.7443619892,östergötland,5
15901,21130,5229,2019-05-31,75.25 %,0.7525319451,östergötland,5
15529,20694,5165,2019-06-30,75.04 %,0.7504107471,östergötland,5
13918,18979,5061,2019-07-31,73.33 %,0.733336846,östergötland,5
14681,19228,4547,2019-08-31,76.35 %,0.7635219472,östergötland,5
15262,19689,4427,2019-09-30,77.52 %,0.7751536391,östergötland,5
16005,20323,4318,2019-10-31,78.75 %,0.7875313684,östergötland,5
16081,20565,4484,2019-11-30,78.20 %,0.7819596402,östergötland,5
16159,21171,5012,2019-12-31,76.33 %,0.7632610647,östergötland,5
15834,20772,4938,2020-01-31,76.23 %,0.762276141,östergötland,5
14802,20494,5692,2020-02-29,72.23 %,0.7222601737,östergötland,5
17362,30572,13210,2020-03-31,56.79 %,0.5679052728,östergötland,5
18689,24294,5605,2020-04-30,76.93 %,0.769284597,östergötland,5
16831,21823,4992,2020-05-31,77.13 %,0.7712505155,östergötland,5
15702,22504,6802,2020-06-30,69.77 %,0.6977426235,östergötland,5
14234,19947,5713,2020-07-31,71.36 %,0.7135910162,östergötland,5
15042,21224,6182,2020-08-31,70.87 %,0.7087259706,östergötland,5
15687,22944,7257,2020-09-30,68.37 %,0.683708159,östergötland,5
17279,23975,6696,2020-10-31,72.07 %,0.7207090719,östergötland,5
17055,26413,9358,2020-11-30,64.57 %,0.6457047666,östergötland,5
16616,24471,7855,2020-12-31,67.90 %,0.6790078052,östergötland,5
17356,23160,5804,2021-01-31,74.94 %,0.7493955095,östergötland,5
15292,20175,4883,2021-02-28,75.80 %,0.7579677819,östergötland,5
17252,26216,8964,2021-03-31,65.81 %,0.6580714068,östergötland,5
18146,31170,13024,2021-04-30,58.22 %,0.5821623356,östergötland,5
17129,27435,10306,2021-05-31,62.43 %,0.62434846,östergötland,5
15415,23318,7903,2021-06-30,66.11 %,0.6610772794,östergötland,5
13009,21957,8948,2021-07-31,59.25 %,0.5924762035,östergötland,5
14132,21743,7611,2021-08-31,65.00 %,0.6499563078,östergötland,5
14981,21977,6996,2021-09-30,68.17 %,0.6816671975,östergötland,5
14765,23327,8562,2021-10-31,63.30 %,0.632957517,östergötland,5
14255,20834,6579,2021-11-30,68.42 %,0.684218105,östergötland,5
14046,20897,6851,2021-12-31,67.22 %,0.6721538977,östergötland,5
12745,18239,5494,2017-01-31,69.88 %,0.6987773452,jönköping,6
11464,16704,5240,2017-02-28,68.63 %,0.686302682,jönköping,6
11529,17590,6061,2017-03-31,65.54 %,0.6554292211,jönköping,6
11652,17719,6067,2017-04-30,65.76 %,0.6575991873,jönköping,6
11623,18778,7155,2017-05-31,61.90 %,0.6189690063,jönköping,6
9978,15844,5866,2017-06-30,62.98 %,0.6297652108,jönköping,6
9073,14122,5049,2017-07-31,64.25 %,0.6424727376,jönköping,6
10014,14100,4086,2017-08-31,71.02 %,0.710212766,jönköping,6
10517,15561,5044,2017-09-30,67.59 %,0.6758563074,jönköping,6
10816,16352,5536,2017-10-31,66.14 %,0.6614481409,jönköping,6
10751,16122,5371,2017-11-30,66.69 %,0.6668527478,jönköping,6
11046,16696,5650,2017-12-31,66.16 %,0.6615955918,jönköping,6
11026,17521,6495,2018-01-31,62.93 %,0.6293019805,jönköping,6
9461,16399,6938,2018-02-28,57.69 %,0.5769254223,jönköping,6
10989,18867,7878,2018-03-31,58.24 %,0.5824455398,jönköping,6
10595,16664,6069,2018-04-30,63.58 %,0.6358017283,jönköping,6
11840,17579,5739,2018-05-31,67.35 %,0.6735309176,jönköping,6
11270,17265,5995,2018-06-30,65.28 %,0.652765711,jönköping,6
9364,15674,6310,2018-07-31,59.74 %,0.5974224831,jönköping,6
10436,15285,4849,2018-08-31,68.28 %,0.6827608767,jönköping,6
10852,15664,4812,2018-09-30,69.28 %,0.6927987743,jönköping,6
11258,15579,4321,2018-10-31,72.26 %,0.7226394505,jönköping,6
10611,14234,3623,2018-11-30,74.55 %,0.7454685963,jönköping,6
11542,15119,3577,2018-12-31,76.34 %,0.7634102785,jönköping,6
11598,15235,3637,2019-01-31,76.13 %,0.7612733837,jönköping,6
9849,13494,3645,2019-02-28,72.99 %,0.7298799466,jönköping,6
10553,14404,3851,2019-03-31,73.26 %,0.7326437101,jönköping,6
10416,13918,3502,2019-04-30,74.84 %,0.7483833884,jönköping,6
10493,13739,3246,2019-05-31,76.37 %,0.7637382633,jönköping,6
10798,14300,3502,2019-06-30,75.51 %,0.7551048951,jönköping,6
8705,11795,3090,2019-07-31,73.80 %,0.7380245867,jönköping,6
10058,12932,2874,2019-08-31,77.78 %,0.7777605939,jönköping,6
10679,13636,2957,2019-09-30,78.31 %,0.7831475506,jönköping,6
10516,13303,2787,2019-10-31,79.05 %,0.7904983838,jönköping,6
10277,13154,2877,2019-11-30,78.13 %,0.7812832598,jönköping,6
11044,14325,3281,2019-12-31,77.10 %,0.7709598604,jönköping,6
10573,13993,3420,2020-01-31,75.56 %,0.7555920818,jönköping,6
9430,13275,3845,2020-02-29,71.04 %,0.7103578154,jönköping,6
10087,18516,8429,2020-03-31,54.48 %,0.544772089,jönköping,6
10926,14760,3834,2020-04-30,74.02 %,0.7402439024,jönköping,6
11329,14753,3424,2020-05-31,76.79 %,0.7679116112,jönköping,6
10886,15868,4982,2020-06-30,68.60 %,0.686034787,jönköping,6
8443,12063,3620,2020-07-31,69.99 %,0.6999088121,jönköping,6
9348,13356,4008,2020-08-31,69.99 %,0.6999101527,jönköping,6
9460,13674,4214,2020-09-30,69.18 %,0.6918238994,jönköping,6
10373,14150,3777,2020-10-31,73.31 %,0.7330742049,jönköping,6
10163,15850,5687,2020-11-30,64.12 %,0.6411987382,jönköping,6
9899,14794,4895,2020-12-31,66.91 %,0.6691226173,jönköping,6
11512,15422,3910,2021-01-31,74.65 %,0.7464660874,jönköping,6
9912,13056,3144,2021-02-28,75.92 %,0.7591911765,jönköping,6
10814,16555,5741,2021-03-31,65.32 %,0.6532165509,jönköping,6
9750,16596,6846,2021-04-30,58.75 %,0.5874909617,jönköping,6
9756,15543,5787,2021-05-31,62.77 %,0.6276780544,jönköping,6
9425,14398,4973,2021-06-30,65.46 %,0.6546048062,jönköping,6
7672,13115,5443,2021-07-31,58.50 %,0.5849790316,jönköping,6
8487,13239,4752,2021-08-31,64.11 %,0.6410605031,jönköping,6
8923,13108,4185,2021-09-30,68.07 %,0.6807293256,jönköping,6
9403,15106,5703,2021-10-31,62.25 %,0.6224678936,jönköping,6
8612,12654,4042,2021-11-30,68.06 %,0.6805753122,jönköping,6
8685,13090,4405,2021-12-31,66.35 %,0.6634835752,jönköping,6
18903,23675,4772,2017-01-31,79.84 %,0.79843717,uppsala,3
16534,21877,5343,2017-02-28,75.58 %,0.7557709009,uppsala,3
18855,24183,5328,2017-03-31,77.97 %,0.7796799405,uppsala,3
17240,21832,4592,2017-04-30,78.97 %,0.7896665445,uppsala,3
18288,24384,6096,2017-05-31,75.00 %,0.75,uppsala,3
15724,20542,4818,2017-06-30,76.55 %,0.7654561386,uppsala,3
13423,19198,5775,2017-07-31,69.92 %,0.6991874154,uppsala,3
15579,19243,3664,2017-08-31,80.96 %,0.8095930988,uppsala,3
15840,20621,4781,2017-09-30,76.81 %,0.7681489743,uppsala,3
16598,21719,5121,2017-10-31,76.42 %,0.7642156637,uppsala,3
16257,20956,4699,2017-11-30,77.58 %,0.7757682764,uppsala,3
14113,22084,7971,2017-12-31,63.91 %,0.6390599529,uppsala,3
13348,23369,10021,2018-01-31,57.12 %,0.5711840472,uppsala,3
11945,21583,9638,2018-02-28,55.34 %,0.5534448408,uppsala,3
13306,23419,10113,2018-03-31,56.82 %,0.5681711431,uppsala,3
13923,21145,7222,2018-04-30,65.85 %,0.6584535351,uppsala,3
13134,22203,9069,2018-05-31,59.15 %,0.5915416836,uppsala,3
12368,20322,7954,2018-06-30,60.86 %,0.6086015156,uppsala,3
11492,19840,8348,2018-07-31,57.92 %,0.579233871,uppsala,3
11553,18827,7274,2018-08-31,61.36 %,0.6136399851,uppsala,3
11991,19080,7089,2018-09-30,62.85 %,0.6284591195,uppsala,3
12600,19962,7362,2018-10-31,63.12 %,0.6311992786,uppsala,3
12110,19241,7131,2018-11-30,62.94 %,0.6293851671,uppsala,3
12104,16697,4593,2018-12-31,72.49 %,0.7249206444,uppsala,3
13657,18539,4882,2019-01-31,73.67 %,0.7366632504,uppsala,3
12040,16841,4801,2019-02-28,71.49 %,0.7149219168,uppsala,3
12646,17540,4894,2019-03-31,72.10 %,0.7209806157,uppsala,3
12374,16785,4411,2019-04-30,73.72 %,0.7372058385,uppsala,3
12587,17145,4558,2019-05-31,73.41 %,0.7341498979,uppsala,3
12412,16607,4195,2019-06-30,74.74 %,0.7473956765,uppsala,3
11027,15211,4184,2019-07-31,72.49 %,0.7249359017,uppsala,3
11925,15728,3803,2019-08-31,75.82 %,0.7582019329,uppsala,3
12092,15764,3672,2019-09-30,76.71 %,0.7670641969,uppsala,3
12385,15759,3374,2019-10-31,78.59 %,0.7859001206,uppsala,3
12012,15674,3662,2019-11-30,76.64 %,0.7663646804,uppsala,3
12586,16444,3858,2019-12-31,76.54 %,0.765385551,uppsala,3
13261,17385,4124,2020-01-31,76.28 %,0.7627840092,uppsala,3
12587,18094,5507,2020-02-29,69.56 %,0.6956449652,uppsala,3
14998,26223,11225,2020-03-31,57.19 %,0.5719406628,uppsala,3
14457,20510,6053,2020-04-30,70.49 %,0.7048756704,uppsala,3
13657,19481,5824,2020-05-31,70.10 %,0.701042041,uppsala,3
13423,20967,7544,2020-06-30,64.02 %,0.6401964993,uppsala,3
11383,16925,5542,2020-07-31,67.26 %,0.6725553914,uppsala,3
12558,18052,5494,2020-08-31,69.57 %,0.6956569909,uppsala,3
13957,20905,6948,2020-09-30,66.76 %,0.6676393207,uppsala,3
15911,22564,6653,2020-10-31,70.51 %,0.7051497961,uppsala,3
14799,24644,9845,2020-11-30,60.05 %,0.6005112806,uppsala,3
13340,20432,7092,2020-12-31,65.29 %,0.6528974158,uppsala,3
13402,18696,5294,2021-01-31,71.68 %,0.7168378263,uppsala,3
12159,16707,4548,2021-02-28,72.78 %,0.7277787754,uppsala,3
14569,22275,7706,2021-03-31,65.41 %,0.6540516274,uppsala,3
14193,24198,10005,2021-04-30,58.65 %,0.5865360774,uppsala,3
13068,21003,7935,2021-05-31,62.22 %,0.622196829,uppsala,3
12368,19616,7248,2021-06-30,63.05 %,0.6305057096,uppsala,3
10327,18077,7750,2021-07-31,57.13 %,0.5712784201,uppsala,3
10882,17697,6815,2021-08-31,61.49 %,0.6149064813,uppsala,3
12035,18627,6592,2021-09-30,64.61 %,0.6461051162,uppsala,3
12005,20904,8899,2021-10-31,57.43 %,0.5742920015,uppsala,3
11530,17685,6155,2021-11-30,65.20 %,0.651964942,uppsala,3
12282,19491,7209,2021-12-31,63.01 %,0.6301369863,uppsala,3
11587,17294,5707,2017-01-31,67.00 %,0.6700011565,dalarna,20
10733,16309,5576,2017-02-28,65.81 %,0.658102888,dalarna,20
12011,16637,4626,2017-03-31,72.19 %,0.7219450622,dalarna,20
11247,15462,4215,2017-04-30,72.74 %,0.7273961971,dalarna,20
10821,15066,4245,2017-05-31,71.82 %,0.7182397451,dalarna,20
11104,15317,4213,2017-06-30,72.49 %,0.7249461383,dalarna,20
2397,3413,1016,2017-07-31,70.23 %,0.7023146792,dalarna,20
10702,13409,2707,2017-08-31,79.81 %,0.7981206652,dalarna,20
10504,13865,3361,2017-09-30,75.76 %,0.7575910566,dalarna,20
10310,14682,4372,2017-10-31,70.22 %,0.7022204059,dalarna,20
9964,14015,4051,2017-11-30,71.10 %,0.7109525508,dalarna,20
10768,15819,5051,2017-12-31,68.07 %,0.6807004235,dalarna,20
10991,17218,6227,2018-01-31,63.83 %,0.6383435939,dalarna,20
9089,16038,6949,2018-02-28,56.67 %,0.5667165482,dalarna,20
9792,17675,7883,2018-03-31,55.40 %,0.5540028289,dalarna,20
9618,15660,6042,2018-04-30,61.42 %,0.6141762452,dalarna,20
10213,15390,5177,2018-05-31,66.36 %,0.6636127355,dalarna,20
9575,15555,5980,2018-06-30,61.56 %,0.6155576985,dalarna,20
9091,16572,7481,2018-07-31,54.86 %,0.5485759112,dalarna,20
8769,13968,5199,2018-08-31,62.78 %,0.6277920962,dalarna,20
8815,13524,4709,2018-09-30,65.18 %,0.6518041999,dalarna,20
9136,13403,4267,2018-10-31,68.16 %,0.6816384392,dalarna,20
8942,12810,3868,2018-11-30,69.80 %,0.6980483997,dalarna,20
9731,13439,3708,2018-12-31,72.41 %,0.7240866136,dalarna,20
9891,13460,3569,2019-01-31,73.48 %,0.7348439822,dalarna,20
8661,12404,3743,2019-02-28,69.82 %,0.6982425024,dalarna,20
9265,13212,3947,2019-03-31,70.13 %,0.7012564335,dalarna,20
9095,12657,3562,2019-04-30,71.86 %,0.7185747017,dalarna,20
9025,12410,3385,2019-05-31,72.72 %,0.7272360999,dalarna,20
9051,12539,3488,2019-06-30,72.18 %,0.721827897,dalarna,20
8761,12430,3669,2019-07-31,70.48 %,0.7048270314,dalarna,20
8817,11796,2979,2019-08-31,74.75 %,0.747456765,dalarna,20
8622,11441,2819,2019-09-30,75.36 %,0.7536054541,dalarna,20
8766,11513,2747,2019-10-31,76.14 %,0.7614001563,dalarna,20
8322,11074,2752,2019-11-30,75.15 %,0.7514899765,dalarna,20
9491,12832,3341,2019-12-31,73.96 %,0.7396352868,dalarna,20
9305,12743,3438,2020-01-31,73.02 %,0.7302048183,dalarna,20
8522,12430,3908,2020-02-29,68.56 %,0.6855993564,dalarna,20
8504,15929,7425,2020-03-31,53.39 %,0.5338690439,dalarna,20
9693,13361,3668,2020-04-30,72.55 %,0.7254696505,dalarna,20
8687,11839,3152,2020-05-31,73.38 %,0.7337612974,dalarna,20
7817,12189,4372,2020-06-30,64.13 %,0.6413159406,dalarna,20
7777,11760,3983,2020-07-31,66.13 %,0.6613095238,dalarna,20
7945,11952,4007,2020-08-31,66.47 %,0.6647423025,dalarna,20
7843,11796,3953,2020-09-30,66.49 %,0.6648864022,dalarna,20
7780,11119,3339,2020-10-31,69.97 %,0.6997032107,dalarna,20
7442,12618,5176,2020-11-30,58.98 %,0.5897923601,dalarna,20
8818,13891,5073,2020-12-31,63.48 %,0.6347995105,dalarna,20
9245,13029,3784,2021-01-31,70.96 %,0.7095709571,dalarna,20
8202,11434,3232,2021-02-28,71.73 %,0.7173342662,dalarna,20
9483,15395,5912,2021-03-31,61.60 %,0.615979214,dalarna,20
8547,15690,7143,2021-04-30,54.47 %,0.5447418738,dalarna,20
7721,13207,5486,2021-05-31,58.46 %,0.5846142197,dalarna,20
7320,11998,4678,2021-06-30,61.01 %,0.6101016836,dalarna,20
6699,12161,5462,2021-07-31,55.09 %,0.5508593043,dalarna,20
6753,11112,4359,2021-08-31,60.77 %,0.6077213823,dalarna,20
6687,10520,3833,2021-09-30,63.56 %,0.6356463878,dalarna,20
6636,11325,4689,2021-10-31,58.60 %,0.5859602649,dalarna,20
6564,10230,3666,2021-11-30,64.16 %,0.6416422287,dalarna,20
7141,11592,4451,2021-12-31,61.60 %,0.6160282954,dalarna,20
11978,18861,6883,2017-01-31,63.51 %,0.6350670696,örebro,18
10362,17488,7126,2017-02-28,59.25 %,0.5925205855,örebro,18
11757,19060,7303,2017-03-31,61.68 %,0.616841553,örebro,18
11444,17356,5912,2017-04-30,65.94 %,0.6593685181,örebro,18
11655,18457,6802,2017-05-31,63.15 %,0.6314677358,örebro,18
10911,16774,5863,2017-06-30,65.05 %,0.650470967,örebro,18
10570,16410,5840,2017-07-31,64.41 %,0.6441194394,örebro,18
10552,14842,4290,2017-08-31,71.10 %,0.7109553968,örebro,18
10739,15551,4812,2017-09-30,69.06 %,0.6905665231,örebro,18
11406,16988,5582,2017-10-31,67.14 %,0.6714151166,örebro,18
10854,15361,4507,2017-11-30,70.66 %,0.7065946227,örebro,18
11056,16217,5161,2017-12-31,68.18 %,0.6817537152,örebro,18
10984,17063,6079,2018-01-31,64.37 %,0.6437320518,örebro,18
10037,17209,7172,2018-02-28,58.32 %,0.5832413272,örebro,18
10853,18296,7443,2018-03-31,59.32 %,0.5931897683,örebro,18
10935,17637,6702,2018-04-30,62.00 %,0.6200034019,örebro,18
11086,17664,6578,2018-05-31,62.76 %,0.6276041667,örebro,18
10355,15913,5558,2018-06-30,65.07 %,0.6507258217,örebro,18
9693,16160,6467,2018-07-31,59.98 %,0.5998143564,örebro,18
9958,15056,5098,2018-08-31,66.14 %,0.6613974495,örebro,18
10080,15132,5052,2018-09-30,66.61 %,0.6661379857,örebro,18
10975,16152,5177,2018-10-31,67.95 %,0.679482417,örebro,18
10537,15209,4672,2018-11-30,69.28 %,0.6928134657,örebro,18
10838,14444,3606,2018-12-31,75.03 %,0.7503461645,örebro,18
11224,14975,3751,2019-01-31,74.95 %,0.7495158598,örebro,18
9992,13546,3554,2019-02-28,73.76 %,0.7376347261,örebro,18
10967,14682,3715,2019-03-31,74.70 %,0.7469690778,örebro,18
11200,14465,3265,2019-04-30,77.43 %,0.7742827515,örebro,18
11374,14554,3180,2019-05-31,78.15 %,0.7815033668,örebro,18
10788,14131,3343,2019-06-30,76.34 %,0.7634279244,örebro,18
9405,12540,3135,2019-07-31,75.00 %,0.75,örebro,18
10447,13331,2884,2019-08-31,78.37 %,0.7836621409,örebro,18
10081,12810,2729,2019-09-30,78.70 %,0.7869633099,örebro,18
10406,12964,2558,2019-10-31,80.27 %,0.8026843567,örebro,18
10265,13067,2802,2019-11-30,78.56 %,0.7855666947,örebro,18
11003,14049,3046,2019-12-31,78.32 %,0.7831874155,örebro,18
11231,14231,3000,2020-01-31,78.92 %,0.7891926077,örebro,18
10151,13622,3471,2020-02-29,74.52 %,0.7451916018,örebro,18
11482,19595,8113,2020-03-31,58.60 %,0.5859658076,örebro,18
11822,15610,3788,2020-04-30,75.73 %,0.7573350416,örebro,18
11633,14855,3222,2020-05-31,78.31 %,0.7831033322,örebro,18
10418,15511,5093,2020-06-30,67.17 %,0.6716523757,örebro,18
9373,13769,4396,2020-07-31,68.07 %,0.6807320793,örebro,18
10005,14118,4113,2020-08-31,70.87 %,0.7086697833,örebro,18
10979,16322,5343,2020-09-30,67.27 %,0.6726504105,örebro,18
12025,17746,5721,2020-10-31,67.76 %,0.6776174913,örebro,18
12034,20621,8587,2020-11-30,58.36 %,0.5835798458,örebro,18
10300,16096,5796,2020-12-31,63.99 %,0.6399105368,örebro,18
11245,15618,4373,2021-01-31,72.00 %,0.7200025611,örebro,18
10755,15306,4551,2021-02-28,70.27 %,0.7026656213,örebro,18
11819,18578,6759,2021-03-31,63.62 %,0.6361825815,örebro,18
11635,20572,8937,2021-04-30,56.56 %,0.5655745674,örebro,18
11014,17418,6404,2021-05-31,63.23 %,0.6323343667,örebro,18
9590,14754,5164,2021-06-30,65.00 %,0.6499932222,örebro,18
8755,14458,5703,2021-07-31,60.55 %,0.605547102,örebro,18
9144,13831,4687,2021-08-31,66.11 %,0.661123563,örebro,18
9479,14474,4995,2021-09-30,65.49 %,0.6548984386,örebro,18
10072,16098,6026,2021-10-31,62.57 %,0.6256677848,örebro,18
9378,14115,4737,2021-11-30,66.44 %,0.6643995749,örebro,18
9773,15258,5485,2021-12-31,64.05 %,0.6405164504,örebro,18
11903,14893,2990,2017-01-31,79.92 %,0.7992345397,halland,13
11369,14939,3570,2017-02-28,76.10 %,0.7610281813,halland,13
11801,15545,3744,2017-03-31,75.92 %,0.7591508524,halland,13
11309,14647,3338,2017-04-30,77.21 %,0.7721035024,halland,13
11097,15967,4870,2017-05-31,69.50 %,0.6949959291,halland,13
9760,14869,5109,2017-06-30,65.64 %,0.6563992199,halland,13
10598,16077,5479,2017-07-31,65.92 %,0.6592025875,halland,13
10279,13883,3604,2017-08-31,74.04 %,0.7404019304,halland,13
9310,13449,4139,2017-09-30,69.22 %,0.6922447766,halland,13
9119,13695,4576,2017-10-31,66.59 %,0.6658634538,halland,13
8968,13574,4606,2017-11-30,66.07 %,0.6606748195,halland,13
9426,14566,5140,2017-12-31,64.71 %,0.6471234381,halland,13
9432,15653,6221,2018-01-31,60.26 %,0.6025681978,halland,13
8422,15601,7179,2018-02-28,53.98 %,0.5398371899,halland,13
8933,16775,7842,2018-03-31,53.25 %,0.5325186289,halland,13
8532,14420,5888,2018-04-30,59.17 %,0.5916782247,halland,13
8969,15015,6046,2018-05-31,59.73 %,0.5973359973,halland,13
8429,15274,6845,2018-06-30,55.19 %,0.5518528218,halland,13
8190,16600,8410,2018-07-31,49.34 %,0.493373494,halland,13
8093,14061,5968,2018-08-31,57.56 %,0.5755636157,halland,13
7592,12733,5141,2018-09-30,59.62 %,0.596245975,halland,13
8269,13194,4925,2018-10-31,62.67 %,0.6267242686,halland,13
7900,12154,4254,2018-11-30,65.00 %,0.6499917723,halland,13
7565,10978,3413,2018-12-31,68.91 %,0.6891054837,halland,13
7914,11342,3428,2019-01-31,69.78 %,0.6977605361,halland,13
6773,10225,3452,2019-02-28,66.24 %,0.662396088,halland,13
7221,10863,3642,2019-03-31,66.47 %,0.664733499,halland,13
7276,10764,3488,2019-04-30,67.60 %,0.6759568933,halland,13
7567,10947,3380,2019-05-31,69.12 %,0.691239609,halland,13
7485,11026,3541,2019-06-30,67.88 %,0.6788499909,halland,13
7916,11865,3949,2019-07-31,66.72 %,0.6671723557,halland,13
7610,10754,3144,2019-08-31,70.76 %,0.7076436675,halland,13
7449,10279,2830,2019-09-30,72.47 %,0.7246813892,halland,13
7643,10401,2758,2019-10-31,73.48 %,0.7348331891,halland,13
7390,10107,2717,2019-11-30,73.12 %,0.7311764124,halland,13
7339,10474,3135,2019-12-31,70.07 %,0.7006874165,halland,13
7242,10276,3034,2020-01-31,70.47 %,0.7047489295,halland,13
6680,10207,3527,2020-02-29,65.45 %,0.6544528265,halland,13
8664,16663,7999,2020-03-31,52.00 %,0.51995439,halland,13
8712,12495,3783,2020-04-30,69.72 %,0.6972388956,halland,13
8719,12122,3403,2020-05-31,71.93 %,0.7192707474,halland,13
8685,13818,5133,2020-06-30,62.85 %,0.6285280069,halland,13
7749,11983,4234,2020-07-31,64.67 %,0.6466661103,halland,13
8144,12400,4256,2020-08-31,65.68 %,0.6567741935,halland,13
7729,12447,4718,2020-09-30,62.10 %,0.62095284,halland,13
8367,12473,4106,2020-10-31,67.08 %,0.6708089473,halland,13
7754,13504,5750,2020-11-30,57.42 %,0.574200237,halland,13
8365,13592,5227,2020-12-31,61.54 %,0.6154355503,halland,13
9384,13505,4121,2021-01-31,69.49 %,0.6948537579,halland,13
9056,13072,4016,2021-02-28,69.28 %,0.6927784578,halland,13
9023,14853,5830,2021-03-31,60.75 %,0.607486703,halland,13
7482,14325,6843,2021-04-30,52.23 %,0.5223036649,halland,13
7087,12893,5806,2021-05-31,54.97 %,0.5496781199,halland,13
7298,12323,5025,2021-06-30,59.22 %,0.592225919,halland,13
6810,12871,6061,2021-07-31,52.91 %,0.5290964183,halland,13
6992,11982,4990,2021-08-31,58.35 %,0.5835419796,halland,13
6897,11114,4217,2021-09-30,62.06 %,0.6205686522,halland,13
6208,11521,5313,2021-10-31,53.88 %,0.5388421144,halland,13
6171,10065,3894,2021-11-30,61.31 %,0.6131147541,halland,13
6655,11180,4525,2021-12-31,59.53 %,0.5952593918,halland,13
528,602,74,2019-10-31,87.71 %,0.877076412,värmland,17
9412,12922,3510,2019-11-30,72.84 %,0.7283702213,värmland,17
9000,12709,3709,2019-12-31,70.82 %,0.708159572,värmland,17
8584,12204,3620,2020-01-31,70.34 %,0.7033759423,värmland,17
8377,13459,5082,2020-02-29,62.24 %,0.6224087971,värmland,17
11837,20194,8357,2020-03-31,58.62 %,0.5861642072,värmland,17
11006,16343,5337,2020-04-30,67.34 %,0.6734381692,värmland,17
10776,16616,5840,2020-05-31,64.85 %,0.6485315359,värmland,17
10250,18721,8471,2020-06-30,54.75 %,0.5475134875,värmland,17
9781,18908,9127,2020-07-31,51.73 %,0.517294267,värmland,17
10217,18449,8232,2020-08-31,55.38 %,0.5537969538,värmland,17
11598,18062,6464,2020-09-30,64.21 %,0.6421215812,värmland,17
11024,17210,6186,2020-10-31,64.06 %,0.6405578152,värmland,17
12527,19636,7109,2020-11-30,63.80 %,0.6379608882,värmland,17
11405,18287,6882,2020-12-31,62.37 %,0.6236670859,värmland,17
10373,16290,5917,2021-01-31,63.68 %,0.6367710252,värmland,17
10088,15362,5274,2021-02-28,65.67 %,0.6566853274,värmland,17
13685,22121,8436,2021-03-31,61.86 %,0.6186429185,värmland,17
12972,21564,8592,2021-04-30,60.16 %,0.6015581525,värmland,17
11444,18886,7442,2021-05-31,60.60 %,0.6059514985,värmland,17
10806,20235,9429,2021-06-30,53.40 %,0.5340252039,värmland,17
10448,21294,10846,2021-07-31,49.07 %,0.4906546445,värmland,17
10208,19027,8819,2021-08-31,53.65 %,0.5365007621,värmland,17
10020,16684,6664,2021-09-30,60.06 %,0.6005754016,värmland,17
10505,17715,7210,2021-10-31,59.30 %,0.5930002822,värmland,17
11142,18675,7533,2021-11-30,59.66 %,0.596626506,värmland,17
11418,19600,8182,2021-12-31,58.26 %,0.5825510204,värmland,17
13576,17276,3700,2017-01-31,78.58 %,0.7858300533,västmanland,19
12195,15874,3679,2017-02-28,76.82 %,0.7682373693,västmanland,19
12539,16807,4268,2017-03-31,74.61 %,0.74605819,västmanland,19
12778,16589,3811,2017-04-30,77.03 %,0.7702694557,västmanland,19
12676,17673,4997,2017-05-31,71.73 %,0.7172523058,västmanland,19
12010,16523,4513,2017-06-30,72.69 %,0.7268655813,västmanland,19
10258,14453,4195,2017-07-31,70.97 %,0.7097488411,västmanland,19
10655,13746,3091,2017-08-31,77.51 %,0.7751345846,västmanland,19
11239,14783,3544,2017-09-30,76.03 %,0.7602651695,västmanland,19
11185,15141,3956,2017-10-31,73.87 %,0.7387226735,västmanland,19
10811,14560,3749,2017-11-30,74.25 %,0.7425137363,västmanland,19
11446,15388,3942,2017-12-31,74.38 %,0.7438263582,västmanland,19
11517,16919,5402,2018-01-31,68.07 %,0.6807139902,västmanland,19
10275,16741,6466,2018-02-28,61.38 %,0.6137626187,västmanland,19
11253,18492,7239,2018-03-31,60.85 %,0.6085334199,västmanland,19
10958,16231,5273,2018-04-30,67.51 %,0.6751278418,västmanland,19
11607,17031,5424,2018-05-31,68.15 %,0.6815219306,västmanland,19
10327,14696,4369,2018-06-30,70.27 %,0.7027082199,västmanland,19
10049,15442,5393,2018-07-31,65.08 %,0.6507576739,västmanland,19
10087,14250,4163,2018-08-31,70.79 %,0.7078596491,västmanland,19
10117,14158,4041,2018-09-30,71.46 %,0.7145783303,västmanland,19
10716,14762,4046,2018-10-31,72.59 %,0.7259178973,västmanland,19
10140,13875,3735,2018-11-30,73.08 %,0.7308108108,västmanland,19
11131,14248,3117,2018-12-31,78.12 %,0.7812324537,västmanland,19
10910,13961,3051,2019-01-31,78.15 %,0.7814626459,västmanland,19
9819,12858,3039,2019-02-28,76.36 %,0.7636490901,västmanland,19
10162,13191,3029,2019-03-31,77.04 %,0.7703737397,västmanland,19
10157,13042,2885,2019-04-30,77.88 %,0.7787915964,västmanland,19
10453,13193,2740,2019-05-31,79.23 %,0.792314106,västmanland,19
9889,12836,2947,2019-06-30,77.04 %,0.7704113431,västmanland,19
8765,11380,2615,2019-07-31,77.02 %,0.7702108963,västmanland,19
9404,11648,2244,2019-08-31,80.73 %,0.8073489011,västmanland,19
9687,12099,2412,2019-09-30,80.06 %,0.8006446814,västmanland,19
9844,12307,2463,2019-10-31,79.99 %,0.7998699927,västmanland,19
9535,12061,2526,2019-11-30,79.06 %,0.7905646298,västmanland,19
9832,12768,2936,2019-12-31,77.01 %,0.7700501253,västmanland,19
10258,13220,2962,2020-01-31,77.59 %,0.7759455371,västmanland,19
9423,12868,3445,2020-02-29,73.23 %,0.7322816288,västmanland,19
10069,18081,8012,2020-03-31,55.69 %,0.5568829158,västmanland,19
11138,15044,3906,2020-04-30,74.04 %,0.740361606,västmanland,19
9909,12636,2727,2020-05-31,78.42 %,0.7841880342,västmanland,19
9267,13744,4477,2020-06-30,67.43 %,0.674257858,västmanland,19
8702,12186,3484,2020-07-31,71.41 %,0.7140981454,västmanland,19
8771,12029,3258,2020-08-31,72.92 %,0.7291545432,västmanland,19
9747,14006,4259,2020-09-30,69.59 %,0.695916036,västmanland,19
9682,13550,3868,2020-10-31,71.45 %,0.7145387454,västmanland,19
11116,18146,7030,2020-11-30,61.26 %,0.612586796,västmanland,19
10116,15289,5173,2020-12-31,66.17 %,0.6616521682,västmanland,19
10585,14276,3691,2021-01-31,74.15 %,0.7414541888,västmanland,19
9816,13017,3201,2021-02-28,75.41 %,0.7540908043,västmanland,19
10124,15576,5452,2021-03-31,65.00 %,0.6499743195,västmanland,19
9889,16720,6831,2021-04-30,59.14 %,0.5914473684,västmanland,19
10361,15820,5459,2021-05-31,65.49 %,0.6549304678,västmanland,19
9723,13920,4197,2021-06-30,69.85 %,0.6984913793,västmanland,19
7791,12066,4275,2021-07-31,64.57 %,0.6456986574,västmanland,19
8432,12279,3847,2021-08-31,68.67 %,0.6867008714,västmanland,19
9102,12825,3723,2021-09-30,70.97 %,0.7097076023,västmanland,19
9430,14049,4619,2021-10-31,67.12 %,0.671222151,västmanland,19
9144,13386,4242,2021-11-30,68.31 %,0.6831017481,västmanland,19
9496,13889,4393,2021-12-31,68.37 %,0.6837065303,västmanland,19
94567,85818,8749,2017-01-31,,0.9074835831,stockholm,1
91099,83935,7164,2017-02-28,,0.9213602784,stockholm,1
101285,91535,9750,2017-03-31,,0.9037369798,stockholm,1
91269,83190,8079,2017-04-30,,0.911481445,stockholm,1
96860,88577,8283,2017-05-31,,0.9144848235,stockholm,1
87970,80023,7947,2017-06-30,,0.9096623849,stockholm,1
77447,71022,6425,2017-07-31,,0.9170400403,stockholm,1
87565,82735,4830,2017-08-31,,0.9448409753,stockholm,1
90451,84639,5812,2017-09-30,,0.9357442151,stockholm,1
96734,91011,5723,2017-10-31,,0.9408377613,stockholm,1
95553,90494,5059,2017-11-30,,0.9470555608,stockholm,1
100140,93289,6851,2017-12-31,,0.9315857799,stockholm,1
111101,104524,6577,2018-01-31,,0.9408016129,stockholm,1
109418,102489,6929,2018-02-28,,0.936674039,stockholm,1
115312,107436,7876,2018-03-31,,0.9316983488,stockholm,1
101144,93139,8005,2018-04-30,,0.9208554141,stockholm,1
117248,108170,9078,2018-05-31,,0.9225743723,stockholm,1
103791,92247,11544,2018-06-30,,0.8887764835,stockholm,1
90947,81873,9074,2018-07-31,,0.9002276051,stockholm,1
98000,90517,7483,2018-08-31,,0.9236428571,stockholm,1
101341,95726,5615,2018-09-30,,0.9445930078,stockholm,1
106410,99394,7016,2018-10-31,,0.9340663471,stockholm,1
101334,90701,10633,2018-11-30,,0.8950697693,stockholm,1
102319,90038,12281,2018-12-31,,0.8799734165,stockholm,1
110718,99998,10720,2019-01-31,,0.9031774418,stockholm,1
101728,92318,9410,2019-02-28,,0.9074984272,stockholm,1
111530,94003,17527,2019-03-31,,0.8428494575,stockholm,1
103967,88346,15621,2019-04-30,,0.8497504016,stockholm,1
108301,98360,9941,2019-05-31,,0.9082095272,stockholm,1
107112,92465,14647,2019-06-30,,0.8632552842,stockholm,1
91317,81988,9329,2019-07-31,,0.8978393946,stockholm,1
99028,91360,7668,2019-08-31,,0.9225673547,stockholm,1
101055,90378,10677,2019-09-30,,0.8943446638,stockholm,1
103049,92729,10320,2019-10-31,,0.8998534678,stockholm,1
106397,92341,14056,2019-11-30,,0.867891012,stockholm,1
110185,95731,14454,2019-12-31,,0.8688206199,stockholm,1
116749,103635,13114,2020-01-31,,0.8876735561,stockholm,1
125204,102708,22496,2020-02-29,,0.8203252292,stockholm,1
250390,137686,112704,2020-03-31,,0.5498861776,stockholm,1
163082,146479,16603,2020-04-30,,0.8981923204,stockholm,1
134329,124742,9587,2020-05-31,,0.9286304521,stockholm,1
139447,114574,24873,2020-06-30,,0.8216311574,stockholm,1
110106,92730,17376,2020-07-31,,0.8421884366,stockholm,1
112070,88834,23236,2020-08-31,,0.7926652985,stockholm,1
122052,98831,23221,2020-09-30,,0.8097450267,stockholm,1
128451,100593,27858,2020-10-31,,0.7831235257,stockholm,1
170842,105154,65688,2020-11-30,,0.6155043842,stockholm,1
154378,126971,27407,2020-12-31,,0.8224682273,stockholm,1
126821,114038,12783,2021-01-31,,0.8992043904,stockholm,1
118569,101622,16947,2021-02-28,,0.8570705665,stockholm,1
155098,121429,33669,2021-03-31,,0.7829178971,stockholm,1
167059,107134,59925,2021-04-30,,0.641294393,stockholm,1
184068,113297,70771,2021-05-31,,0.6155170915,stockholm,1
178749,109517,69232,2021-06-30,,0.6126859451,stockholm,1
144629,90275,54354,2021-07-31,,0.6241832551,stockholm,1
155913,98790,57123,2021-08-31,,0.6336225972,stockholm,1
160075,108160,51915,2021-09-30,,0.6756832735,stockholm,1
156541,103947,52594,2021-10-31,,0.6640241215,stockholm,1
164049,95712,68337,2021-11-30,,0.583435437,stockholm,1
204395,107946,96449,2021-12-31,,0.5281244649,stockholm,1
233913,139060,94853,2022-01-31,,0.5944945343,stockholm,1
121145,92271,28874,2022-02-28,,0.7616575179,stockholm,1
109099,93023,16076,2022-03-31,,0.8526475953,stockholm,1
114303,90156,24147,2022-04-30,,0.7887457022,stockholm,1
117888,94256,23632,2022-05-31,,0.7995385451,stockholm,1
130195,88869,41326,2022-06-30,,0.6825838166,stockholm,1
104873,70412,34461,2022-07-31,,0.6714025536,stockholm,1
108735,71436,37299,2022-08-31,,0.6569733756,stockholm,1
107038,87557,19481,2022-09-30,,0.8179992152,stockholm,1
105045,88850,16195,2022-10-31,,0.8458279785,stockholm,1
104160,89765,14395,2022-11-30,,0.8617991551,stockholm,1
123907,86234,37673,2022-12-31,,0.695957452,stockholm,1
108162,90521,17641,2023-01-31,,0.8369020543,stockholm,1
96013,81277,14736,2023-02-28,,0.8465207836,stockholm,1
108654,88046,20608,2023-03-31,,0.8103337199,stockholm,1
99146,78555,20591,2023-04-30,,0.7923163819,stockholm,1
103055,78767,24288,2023-05-31,,0.7643200233,stockholm,1
96565,69843,26722,2023-06-30,,0.7232744783,stockholm,1
86715,61253,25462,2023-07-31,,0.7063714467,stockholm,1
93697,68328,25369,2023-08-31,,0.7292442661,stockholm,1
103261,73931,29330,2023-09-30,,0.715962464,stockholm,1
102382,75967,26415,2023-10-31,,0.7419956633,stockholm,1
111863,71598,40265,2023-11-30,,0.6400507764,stockholm,1
122143,74108,48035,2023-12-31,,0.6067314541,stockholm,1